учебник: учебник учебники учебниках учебников
начинающий: начинающих
продвинуть: продвинутые продвинутых продвинутыми
поиск: поиска поиск поиске поиски
присоединяться: присоединяйтесь
мы: нам мы нас нами
различный: различными различным различного различных различные различной
тематика: тематикам
дмитрий: дмитрий
виноградов: виноградов
подробный: подробные подробную подробный подробнее подробное подробней
никакой: никакие никакого никаких
другой: других другое другим другому другие другую другая другого другими
человек: люди людей человек
иметь: имеют имеем иметь имеет
этот: этот эту этому этими этих эта эти этой
сайт: сайтам сайту сайт сайта сайтом сайте
отношение: отношений отношения
просто: просто
заниматься: занимаюсь занимаются заниматься
плагиат: плагиатом
в: в во
публиковать: публикую
ссылка: ссылками ссылкам ссылки ссылке ссылка ссылку
интересный: интересный интересны интересная интереснее интересен интересными поинтереснее интересных интересной интересна интересное интересные
полезный: полезная полезных полезный полезные полезной полезны
статья: статьи статью статья статье
обсудить: обсудим обсудить
вопрос: вопросов вопросами вопросы вопроса вопросом вопросах вопрос
проблема: проблемы проблем проблема проблемой
возникать: возникать возникающие возникают
разработка: разработку разработки разработкой разработке разработка
группа: группой группе группа группы группу групп
вконтакте: вконтакте
поддержка: поддержка поддержку
проект: проектах проекту проекте проекты проекта проектов проект
всё: все всё
право: права
защитить: защищен защищены
копирование: копирование
материал: материалов материалы материала материал
возможно: возможно
разрешение: разрешения разрешением разрешение разрешениях
автор: автор автору авторов авторе авторы автора
при: при
возникновение: возникновении
какой: каком какое какого каким какую какие какая каких какому какой
либо: либо
использовать: используем использовать использовали использовал использую использовав использованы используют используемый использованного использует использован используете используя использовало используйте
урок: уроков урокам уроком уроки уроке уроках урок урока уроками уроку
хранение: хранении хранения хранение
данные: данных данным данными
полный: полной полного полное полный
список: списках списков список списку списком списками списки списке списка
помощь: помощью
хватить: хватит хватило
поговорить: поговорим поговорить
несколько: нескольких несколькими несколько
способ: способом способ способы способов способа способами
качество: качестве
аналогия: аналогия аналогии аналогию аналогий
привести: приведу приведет привести приведенные
виндовыя: виндовые
файл: файлами файлу файл файлах файлы файлов файла файлам файле
база: базы база базе базой базу
таблица: таблиц таблица таблицами таблицу таблице таблицей таблицах таблицы
обычный: обычная обычные обычной обычного обычный обычном обычную обычное обычных
внутренний: внутренний внутренние внутренняя
внешний: внешние внешний
карта: карту карте карты карта
начать: начать начал начнет начнем
сам: самом само сами самого сам самим самому сама
простой: попроще простых простое простым простого простые простой простейший простом
значение: значений значения значениях значениями значение значением значении значениям
сохраняться: сохраняются сохранялись
вид: вид видов виды виде
пара: пары парой пару парами пара пар
имя: именами именем имени имя имен именам имена
так: т так
например: например
разработать: разработаем разработал
приложение: приложению приложениях приложениям приложений приложение приложения приложении приложением
немой: нем
поле: полями поле полях полей поля
ввод: ввода
текст: текстом текст текстов тексту тексты текста тексте
два: двух две двум два двумя
кнопка: кнопкой кнопке кнопки кнопками кнопку кнопкам кнопка кнопок
по: по
нажатие: нажатие нажатию нажатия нажатий нажатием нажатии нажатиям
быть: был будете е будем будет буду будут
сохранять: сохраняете сохранять сохраняли сохраняем сохраняю
загружать: загружать загружайте
создать: созданный создано созданной созданному создав создайте созданным создана создало создать создан создала создаст созданные создадим созданном создам создал созданное созданных созданного созданы создали
открыть: открыв открыт откроем откройте откроете открыты открыли открыть
экран: экрана экранов экранах экран экранами экране экраны экрану экранам
теперь: теперь
писать: пишете писать писал пишите пишу пишем
код: коде кодам кодом кода коды код
определение: определения определение
элемент: элементом элементами элементам элемента элементы элемент элементов элементу элементе элементах
присвоение: присвоения присвоением присвоение
обработчик: обработчиков обработчиком обработчик обработчиках обработчики обработчике обработчику обработчика
реализация: реализации реализация реализаций реализацию
понятно: понятно
обычно: обычно
метод: методы методах метода методов методами методам методу метод методом методе
который: которому которые которого которой которыми котором которая которую которое который которых которым
вызывать: вызываете вызываем вызывайте вызывали вызывает вызывают вызывать вызываю вызывал вызываемого
сохранение: сохранение сохранения сохранении
сначала: сначала
получать: получайте получать получал получает получаем
объект: объекты объекту объектами объектов объект объектом объекте объекта
класс: классы классом классу классов классе класс класса
позволять: позволяющая позволяют позволять позволяющих позволяет
работать: работая работает работаем работать работающем работал работают работающему работаете работали
читать: читает читать
константа: константу константы константа констант константе
использоваться: использовалась использоваться используется используются использовался
настройка: настройки настройками настроек настройкой настройке
доступ: доступ доступа
означать: означают означает означать означающую означающий
дать: дали дать даст дадим дала дав данные дал
видный: видны виден видна
далее: д далее
редактировать: редактируемых редактируете редактировать
необходимый: необходимы необходимые необходимых необходимого необходимую необходим необходимым необходимый
указывать: указывали указывать указывающий указывая указывает указываете указываю указывающая указываем
наименование: наименования наименование
переменный: переменных переменной переменная переменные переменную
это: этим это
содержимое: содержимого содержимое содержимым содержимому
чтобы: чтобы
сохраниться: сохранится сохранились сохранятся сохранилось
необходимо: необходимо
выполнить: выполнит выполнило выполнили выполнены выполните выполнен выполнил выполнить
и: и
наглядность: наглядности
выводить: выводили выводим выводит выводить
сообщение: сообщения сообщений сообщением сообщение
сохранить: сохраним сохранены сохранило сохранить сохраненные сохраните
загрузка: загрузки загрузка
снова: снова
указываться: указываются указывается
хотя: хотя
запись: записей записи запись
здесь: здесь
интересовать: интересующих интересовать интересует интересующие интересующим
чтение: чтения чтение
читаемый: читаем
параметр: параметре параметрами параметру параметры параметров параметра параметр параметром параметрах
умолчание: умолчанию
пустой: пустыми пустым пустую пуст пуста пустой пустая пустое
строка: строках строку строки строкам строк строке строка строкой
считать: считаю считать считаны считало считаем считают
запускать: запускал запуская запускать запускаем запускает запускаете запускайте
для: для
начало: начале начало начала
давать: давайте дает давать даем давал дают даю давая
убедиться: убедились убедиться убедимся убедитесь
принцип: принципу принципе принципов принцип
нужно: нужно
ввести: введенное ввели ввести введем введенными введите
нить: нить
нажимать: нажимая нажимаем нажимайте нажимают нажимать
закрыть: закрыли закрыть закроет закройте
назад: назад
найти: найдите найдете нашел нашло найдет найти найдем нашёл нашла
общий: общем общую общие общей общее общий
эмулятор: эмуляторе эмулятор эмулятора
запустить: запустите запустил запустим запустившее запустили запустить запущено запустив запущен
то: то
вводить: вводили ввожу вводим вводить
пропасть: пропало
закрытие: закрытии закрытия закрытие
программа: программам программе программа программой программы программу
попробовать: попробуете попробую попробуйте попробуем
нажать: нажатую нажмем нажмите нажатый нажали нажато нажатом нажав нажата нажать нажат нажатого
система: системы системой система системе систем систему
закрой: закроем
считаться: считалось считаться считается
отобразиться: отобразилось отобразятся отобразились отобразился отобразилась отобразится
сделать: сделанный сделали сделаны сделано сделайте сделаю сделать сделаем сделал
происходить: происходящего происходить происходило происходили происходит
автоматически: автоматически
открытие: открытии открытия открытие
жать: жмите жать жмет жмете жмем
добавлять: добавляете добавляем добавляет добавляли добавлять
закрывать: закрывать закрывает закрываем
открывать: открываете открывать открывает открывайте открываем
потеряться: потеряются потеряться потерялись
также: также
момент: момент моментов момента
ваш: вашим вашего вашем ваш ваши вашу ваше ваших ваша вашему
решать: решает решать решаем
событие: события событие событий событию
главное: главное
уметь: умеют уметь умеете умеем умеет
ещё: еще
немного: немного
слово: словом слово слова словами словам слов
тема: тему тема темы теме темам темой
мочь: могла можете можем может могу мог могут могли
посмотреть: посмотрите посмотреть посмотрел посмотрим
меню: меню
выбрать: выбранного выбрано выберем выбранной выбранные выбрана выбранный выбранным выбран выберите выбрать
файловый: файловая файловой
папка: папка папке папку папки папок
видеть: видит видели видеть вижу видите видим
если: если
выгрузить: выгрузить
комп: компе компы комп
увидеть: увидите увидим увидеть увидит увидели
следующий: следующими следующем следующие следующий следующую следующей следующих следующим следующее следующая
верно: верно
обратить: обратим обратите обратить
внимание: внимание внимания
путь: пути путь
наш: нашего нашей наше наших нашими наша нашим нашему наши нашем наш
разобраться: разобраться разберемся разобрался разобрались
откуда: откуда
взяться: взялось
кроме: кроме
он: нему его ему он
выполнять: выполняю выполняете выполняющий выполняет выполнять выполнял выполняем
абсолютно: абсолютно
тот: теми той те ту тех тот тому та
функция: функция функциях функциям функции функций
указать: указано укажите укажем указал указан указать указаны указанным указали
получение: получения получение
исходник: исходник исходники
браться: берется
текущий: текущая текущего текущем текущим текущие текущий текущее текущую текущей
отсюда: отсюда
появиться: появился появиться появившемся появилось появилась появится появились
итог: итог итогу итоге итогам
хотеть: хочет хочу хотим хотите хотел хотели
выдумывать: выдумывать
выбирать: выбирайте выбираем выбираете выбирает выбирать
кстати: кстати
меняться: меняются меняться меняется менялось
на: на
канал: канала канале каналы каналов
публиковаться: публикуются
новый: нового новых новые новую новой новыми новым новый новом новое новая
хабра: хабра
п: п
чат: чатах чатам чат чаты
хотеться: хочется хотелось
коллега: коллегами
обсуждение: обсуждения
производительность: производительности производительность
пожелание: пожеланий
содержание: содержанию содержание содержания
курс: курсы курсов курсе курсом курс курса курсу курсами
паттерн: паттерном паттерна паттерн
возможность: возможность возможности возможностью возможностях
библиотека: библиотеки библиотека библиотеками библиотек
брать: брать беру берет берут берем
часть: частей частями части часть частью
упрощать: упрощает
работа: работы работу работе работа
разработчик: разработчикам разработчиков разработчиками разработчик разработчику разработчики разработчика
снижать: снижает
количество: количество количества количеству
написать: напишите написанного написаны написать написан написали написанный напишем написано напишу написанное написал написанные
сегодняшний: сегодняшний
день: день
приобрести: приобрели приобрести
хороший: лучший лучшего хорошее хорошую лучше хорошая
десять: десять
прочитать: прочитав прочитать прочитал
поэтому: поэтому
взглянуть: взгляните
пример: примерах примером пример примера примеров примере примерами примеры
мой: мое моих моего моей мои мою моем
наглядно: наглядно
объяснять: объясняю объяснять объясняет
польза: польза
создание: создании созданию создания создание
изучать: изучать изучая изучаем
прийтись: пришлось придется
просмотреть: просмотреть просмотрев просмотрит
ресурс: ресурсов ресурсе ресурсы ресурсах ресурса ресурсам ресурс ресурсами ресурсу
нигде: нигде
информация: информацией информация информации информацию
потратить: потрачу потратил
куча: куча кучей кучу кучи куче
время: временем время времени
тестовый: тестового тестовыми тестовые
эксперимент: эксперименты эксперимента
конец: конец конце конца
тогда: тогда
понять: поняли понять понял
свой: своего свои своими своей своих своем своему свое свой своя своим
я: я мною мне меня
обобщить: обобщил
собрать: собранную
дополнить: дополнен дополним дополнил
практика: практикой практики практика практике
получиться: получилась получился получившийся получившегося получится получились получиться получилось
полноценный: полноценный
стиль: стилю стиля стиле стилем стили стиль стилей
доступно: доступно
шаг: шагам шаге шаг шаги шагов
картинка: картинка картинку картинке картинок картинками картинки
визуальный: визуальные визуальное
схема: схема схемы схемами схем схемой схеме схему
понимание: понимания понимании понимание
рассматривать: рассматриваем рассматривать рассматривали
самый: самых самые самое самым самая самый
последний: последнего последний последняя последним последних последнее последние последней
первый: первому первыми первую первые первом первое первой первым первого первая первых первый
доступный: доступны доступен доступных доступную доступная доступные
бесплатно: бесплатно
регистрация: регистрации
примета: примете
осознанный: осознанное
решение: решений решение решения
покупка: покупке покупку
постоянно: постоянно
дополняться: дополняется
состоять: состоять состоит состоят
оплата: оплаты
стоимость: стоимость
рубль: рублей
с: с
выход: выходе выходом выход выхода
увеличиваться: увеличивается
но: но
читатель: читателю читателя читатели
купить: купившие купившему купите купил купить
получить: получил получили полученной получим получить получат полученных полученного получило полученную получит полученные получены полученный получите получен полученными
откладывать: откладывайте
предоставляться: предоставляется
скидка: скидкой скидка
остальной: остальное остальные остальным остальных
навсегда: навсегда
включая: включая
последующий: последующие последующих
обновление: обновление обновления
сразу: сразу
процент: процентов
докупить: докупить
дополнительный: дополнительными дополнительных дополнительные
второй: вторая вторых второй втором вторую второго вторым
рассмотреть: рассмотрю рассмотрен рассмотреть рассмотрели рассмотрены рассмотренные рассмотрим
некоторый: некоторые некоторых некоторым некотором
третий: третьем третьим третье третий третьего третья третьей
узнать: узнаем узнаете узнали узнать
такой: такие таким такими такую такого такое таких таком такая
задаваться: задаваться задается
жизнь: жизни
четвёртый: четвертого четвертой четвертом четвертый
разобрать: разберем разберет разберешь
асинхронный: асинхронных асинхронной асинхронно асинхронные
механизм: механизм механизмов механизма механизмы
а: а
обрабатывать: обрабатывает обрабатываем обрабатывать
ошибка: ошибку ошибок ошибка ошибке ошибках ошибки
подробно: подробно
билдёр: билдер билдеры билдеров
генерироваться: генерируется генерируются
даггер: даггером
аннотация: аннотация аннотациями аннотаций аннотацией аннотации
передавать: передавать передавая передаю передаете передавали передает передаем
компонент: компоненту компонентах компонентам компонентами компонентом компоненты компонент компонента компонентов компоненте
миновать: минуя
модуль: модуля модуле модулях модулей модулем модуль модули
вариант: вариант вариантов варианта
архитектурный: архитектурного
позволить: позволит позволят
презентер: презентер
поворот: повороты повороте
научиться: научился научились научимся научиться научитесь
создавать: создаваемые создавайте создаваемое создаваемому создаваемой создаю создавая создаваемый создаете создавать создаем создает создаваемого создавали
сабкомпонент: сабкомпоненты
аргумент: аргумент аргумента
упростить: упростить
использование: использовании использование использования использованию использованием
вообще: вообще
вызов: вызове вызов вызовы вызовов вызовом вызовами вызова
браузер: браузера браузер браузере
прошлый: прошлый прошлом прошлой прошлых прошлые
вызвать: вызвать вызвала вызвав вызванные вызвавшую вызвал вызван вызовем вызвана вызовет вызвали вызванных вызвано
адрес: адреса адресом адресу адрес
запускаться: запускается запускаться
отображать: отображает отображал отображать отображающие отображаемый
страница: страницы страница страниц страницу странице
самостоятельно: самостоятельно
реагировать: реагируют реагировать реагирует
отобразить: отобразит отображен отображена отображено отобразили отобразило отобразивший отобразила отобразить отобразил
настроить: настроили настроить настроен настроим настройте
отправлять: отправляющая отправляли отправлять отправляем
рисовать: рисуем рисовать
кодим: кодим
непривычный: непривычен
описывать: описываем описывать описывал описываете описывают описываю описывает
возвращать: возвращаем возвращающий возвращает возвращают возвращаемые возвращать
поддерживать: поддерживает поддерживающими
реализовать: реализуем реализовано реализованы реализующий реализован реализовать реализует
интерфейс: интерфейсы интерфейсе интерфейс интерфейсов интерфейса
отдельно: отдельно
прямо: прямо
маленький: маленькими поменьше маленькие меньше
подойти: подойти подойдет подошла подошли
итак: итак
второе: второе
определять: определять определяют определяем определяет
прописать: прописать прописав пропишем прописано прописал прописан прописали пропишите
манифест: манифест манифесте манифеста
к: к
добавить: добавлен добавлено добавленном добавим добавил добавит добавив добавить добавьте добавила добавили
значит: значит
должный: должны должен должно должна
содержать: содержащую содержит содержала содержали содержащий содержат содержащие содержал содержать
не: не
забывать: забывайте забываем
вкладка: вкладку вкладке вкладка вкладки вкладок
интернет: интернет
выбор: выбором выбор выбора
предлагать: предлагает предлагаю предлагать предлагают
системный: системный системные системным системная системного системной системных
запрос: запрос запросами запросов запроса запросу запросы запросом
просмотр: просмотра просмотр
заявить: заявили
придумать: придумать придумал придуманные придумаем
альтернатива: альтернативу
понимать: понимали понимал понимать понимаем понимает понимаю понимаете
запросто: запросто
показывать: показываю показывают показываем показывает показывать показывающий
можно: можно
или: или
накодить: накодить
скачать: скачать скачал скачали
забить: забить
показать: покажет показана показано показать показало покажут показали показал показала
левый: левому левая левым левую левой левого левее левый
тёмный: темный темном
сообщать: сообщаем сообщает сообщать
внутри: внутри
ерунда: ерунда
программерский: программерской
этика: этики
здравый: здравого
смысл: смысла смысл смыслу
адекватность: адекватности
учиться: учимся
разбирать: разбираем разбирать разбирали разбирает
после: после
изучение: изучения изучению
приступить: приступим приступить
полезно: полезно
знание: знаний знание знаниями знания
пригодиться: пригодиться пригодится
расширить: расширенных расширил расширенный расширенном расширенную расширенное
рекомендовать: рекомендуемый рекомендуемую рекомендуемая рекомендуют рекомендую
прочесть: прочесть прочтет прочли
освежить: освежить
делать: делаю делают делает делал делать делаем делали
называться: называться называются называется
есть: есть
друг: друг другу друга другом
результат: результат результата результату результатов результатом результате результаты
выполнение: выполнение выполнения
как: как
вход: вход
принимать: принимает принимать принимаю принимают
родительский: родительского родительский родительской родительское родительским родительском
присваиваться: присваивается присваиваются
присоединять: присоединять
становиться: становимся становится
родитель: родитель родителю родителя родители родителем родителях
равносильно: равносильно
команда: команде командой
дочерний: дочерней дочерним дочерние дочерняя
соответствовать: соответствующий соответствующее соответствовало соответствует соответствующую соответствующим соответствуют
тут: тут
всякий: всяких всякий
испытывать: испытывать
считывать: считываем
свежесоздать: свежесозданного свежесозданный
передать: переданный переданного передал передали передать передаст
соответственно: соответственно
привязка: привязка привязки привязку привязок
измениться: изменилось изменится изменились изменился
конвертнуть: конвертнуть конвертнули
никуда: никуда
поместить: помещен поместите поместит поместила поместить поместим поместили поместил
висеть: висит висеть висело
память: память памяти
смотреть: смотреть смотрим смотрит смотрите см
лог: логах логи логов логами логам лог лога логу
вместо: вместо
произойти: произойдет произошло произошла
именно: именно
изменить: изменить изменим изменены изменив
делаться: делается
выделить: выделенной выделили выделенного выделен выделим выделите выделенных выделенные выделенный выделить
наслать: нашли
добавиться: добавятся добавился добавится добавиться
переписать: перепишем
находить: находит находим находил
оставлять: оставляйте оставляем оставлять
поменяться: поменялся поменялись поменялось
что: чём чему что
видно: видно
различаться: различаются различается
случай: случай случаях случаи случаев случае
потому: потому
внести: внести внесем внесены
изменение: изменения изменениях изменений
убирать: убираете убираем убирая
выведение: выведения
сейчас: сейчас
почему: почему
наложиться: наложились
расположение: расположение расположения
данный: данный данном
существенно: существенно
вернуть: вернуть вернул вернет вернула
аналогично: аналогично
закрепление: закрепления
введение: введение введения
рассказать: рассказал расскажу рассказать расскажут
подключить: подключить подключим подключенного
зачем: зачем
нужный: нужен нужны нужна нужного нужной нужным нужная нужную нужный
снизить: снизят снизить
зависимость: зависимостей зависимости зависимость
написание: написании написание написания
тест: теста тесты тестами тест тестов тестах
помочь: помогут помогла помочь поможет
минь: мини
описать: описали описать опишем описан описал описана описанных описано опишу
версия: версий версия версией версиями версию версии версиях
даггера: даггер даггера даггеру
плюс: плюсы плюсом плюсам
сравнение: сравнению сравнении
генерировать: генерирует
несложный: несложный несложных несложные несложную несложен
отладка: отладки
проверять: проверял проверять проверяем проверяет
этап: этапе
компиляция: компиляция компиляции
сказать: скажу сказать сказанное скажет
нетривиальный: нетривиальная
тип: типа типам типов тип типу типом типами типы
очень: очень
иной: ином
сильно: сильно
теория: теории теорией теорию теория
понадобиться: понадобился понадобятся понадобится понадобиться понадобилось
небольшой: небольшими небольшом небольшой небольшую небольшое небольшая
абстрактный: абстрактная абстрактный
смоделировать: смоделируем
ситуация: ситуации ситуацию ситуаций ситуация
один: одном одним одни один одно одному одну одной одного одна
повлечь: повлечь
себя: собой
пусть: пусть
некий: некий некие некая некое
соответствие: соответствии соответствие
презентёр: презентера презентеру
очередь: очередь
выглядеть: выглядели выглядят выглядит выглядеть
важно: важно
создаваться: создаваться создаются создается
сколько: сколько
потребоваться: потребуются потребоваться потребуется
применимый: применимо применим
разумеется: разумеется
исчезнуть: исчезнут исчез исчезло исчезнет
вынести: вынесли вынесем вынес вынесен
отдельный: отдельный отдельными отдельным отдельной отдельном отдельное отдельные
иерархия: иерархию иерархия
перенос: переносом
частично: частично
дублировать: дублировать
существовать: существуют существовал существовать существует
место: места месте место
экземпляр: экземпляре экземпляр экземпляра
везде: везде
изнутри: изнутри
взять: взять взяты возьмет возьмем
нужда: нужд
обычай: обычая
обращаться: обращаться обращается обращаемся
ключевой: ключевых ключевые
понятие: понятия понятий понятие понятиях
помещать: помещает помещали помещать помещаемые помещаем помещаете
каждый: каждый каждому каждые каждом каждая каждую каждой каждым каждого
включать: включаем включает
близкий: ближайшую ближе ближайших близкие
связанный: связанной связанных
пользователь: пользователь пользователей пользователю пользователями пользователем пользователя пользователи
посредник: посредник
когда: когда
знать: знать знает знаем знаете знаю знало знал
просить: просили просим прошу просит
искомый: искомый искомого
процесс: процессе процесс процесса
сравнить: сравнить
обед: обедом
клиент: клиент клиенту
кассир: кассир кассиру
производственный: производственная производственной
линия: линией линия линий линию линии
заказ: заказе заказ
бигмак: бигмак бигмака
картошка: картошку картошки картошка
кола: колу колы кола
определиться: определился определиться
говорить: говорить говорит говорим говорили говорил
ходить: ходит
собирать: собирает собирать
наливать: наливает
насыпать: насыпает
комплектовать: комплектует
пакет: пакет пакета
поднос: поднос
выдавать: выдает
требовать: требуемые требуемого требуемый требует требуемое требуемыми
отдавать: отдает отдаем
раздел: раздел раздела разделе разделы
удалить: удалите удалим удалены удалили удалить удалено
воспользоваться: воспользоваться воспользуйтесь
запрашивать: запрашивали запрашивает запрашивать запрашиваемых
они: они ими их ними
важный: важные важен важна важная важное
предположим: предположим
предоставлять: предоставлять предоставляет предоставляем предоставляют
весь: всей всего всему всем весь вся
являться: являющийся являются является
поставщик: поставщиком
технически: технически
вполне: вполне
обойтись: обойтись
логичный: логичнее
разделить: разделит разделил разделить
область: область области
применение: применения
готовый: готовы готовое готов готова готовые готовый готово
пока: пока
сгенерировать: сгенерирован сгенерированном сгенерирует сгенерированные
требоваться: требуется
наполнить: наполнит наполнить
сбор: сборе
заполнять: заполняет заполняем заполняете заполнять заполняли
оба: обеих обе обоими обоих обеим оба
смочь: сможем смогло сможете смогут сможет смог
искать: искать ищем ищете ищите ищет
любой: любая любом любому любой любым любого
захотеть: захотите захотим
проверить: проверим проверить проверит
достать: достать
нагенерить: нагенерит
остаться: осталось остались остаться оставшихся останется
забыть: забудьте забыл
среда: среды среду сред средой среде среда
скорее: скорее
ругаться: ругаться ругается
скомпилировать: скомпилируйте скомпилировать
завершиться: завершится завершилось
недра: недрах
студия: студии студия
запуск: запусков запуск запуска запуске запусках
крэшитый: крэшит
у: у
штука: штук штука
удобный: удобный удобнее удобен удобное удобна удобных удобней удобная
научить: научить научим
наполнять: наполнять наполняет наполняем
соответствующий: соответствующих соответствующие
единственный: единственного
тем: тем
туда: туда
ожидать: ожидать ожидаем ожидает ожидаемый ожидаемой
наличие: наличие
пометить: помеченных пометить
специальный: специальными специальная специальный
определить: определить определило определит определены определено определен определили определена
подставлять: подставлять подставлял
помечать: помечаем
заполнить: заполнены заполнена заполните заполнен заполненный заполненными заполним заполнить
вытащить: вытащит
пойти: пошел пойдут пойдем пошло пойдет пойти
далёкий: дальше
внутрь: внутрь
проверка: проверка проверку проверки
вместе: вместе
простота: простоты
совокупность: совокупность
граф: граф
выше: выше
предоставить: предоставлена предоставить предоставит
десятка: десяток
попросить: попросим попросит попросили
прийти: придем пришедшие придет пришедший пришла пришел пришло
цепочка: цепочку
бывать: бывает бывают
извне: извне
относить: относят
построение: построения построении
инджект: инджекте
пытаться: пытаемся пытаетесь пытаться пытался
компилятор: компилятор
закономерно: закономерно
жаловаться: жалуется
основа: основой основы
особый: особый особых
подробность: подробностей подробности
сложность: сложностей сложности
роль: роли
организовать: организовать организованы организовано
изучить: изучим изучили изучил
поток: потоков потока поток потоками потоке
комментарий: комментарии
забавный: забавная
макдональдс: макдональдсом
получаться: получалось получается
сильный: силён
англицкий: англицком
вроде: вроде
причина: причины причину причина причинам
толькоdependencies: толькоdependencies
кто: кому кого
благодарить: благодарю
качественный: качественное
изложение: изложение изложения
сформироваться: сформировалась
картина: картина
пройти: пройдет пройдите пройден прошла пройденного прошли прошел прошло пройти
диагональ: диагональ диагонали
уверенность: уверенностью
круто: круто
досконально: досконально
пропустить: пропустите пропустил пропустить пропустили пропущенная пропустит
адаптировать: адаптировал
особенно: особенно
спасибо: спасибо
мелочь: мелочи
линк: линки
док: доки дока доках
гитхаб: гитхаб
повествование: повествование
сложный: сложных сложным посложнее сложного сложна сложный сложному
жир: жир
вобщий: вобщем
душа: души
большой: большой большого велика большое
представить: представить представлена
труд: труд
надеяться: надеюсь
собираться: собираюсь собираемся собираетесь
останавливаться: останавливаясь останавливается останавливаться
ибо: ибо
практиковать: практикующего
золото: золото
котлин: котлин
ждать: ждем ждать ждет
поглядывать: поглядываю
тестирование: тестирование тестирования
закончить: закончил закончить закончит закончен
минус: минусам
странный: странный
компилироваться: компилируется
падать: падает
рантайм: рантайме
отличный: отличную
даже: даже
английский: английский английском
сегмент: сегменте сегмент
стартовать: стартованном стартовали стартован стартует
активитя: активити
указатель: указатель
окей: окей
обьект: обьект
сетя: сетю
сетить: сетить
немочь: немогу
нулевой: нулевой
правильно: правильно
думать: думаю думал
спринг: спринге
через: через
причём: причём причем
компонет: компонета
вдумчиво: вдумчиво
нарисовать: нарисовать нарисовал нарисуем
бумага: бумаге
чётко: четко
полка: полкам
красиво: красиво
атрибут: атрибута атрибутах атрибуты атрибутом атрибут атрибуту атрибуте атрибутами атрибутов
звонилка: звонилку звонилка
даваться: дается
указание: указание указания указанием
действие: действий действия действие
редактирование: редактирование
совершаться: совершается
произвести: произвести
подаваться: подается
составлять: составляющие составляет
хранить: хранит хранить
составить: составлена
документ: документом документа документ
извлекать: извлекать извлекаем
распарсенный: распарсенной
название: названии названиями названий название названия названием
двоеточие: двоеточие
пр: пр
там: там
описание: описанию описание описанием описании
свериться: свериться
идти: идет идем идут
дело: деле дело делом
пробел: пробелы пробелов пробел
вокруг: вокруг
особенность: особенностей
разметка: разметки
координата: координат координаты координатам координатах координатами
номер: номер номером номерам номеру номера
телефон: телефонов телефона
контакт: контактов контакт
адресный: адресной
книга: книги книг книге
равный: равны равной равном равным равен
менять: меняем меняет менять меняете
поздний: поздних позднее позже
стандартный: стандартных стандартный стандартные
поддерживаться: поддерживаются
разный: разное разными разному разным разные разных
отсеивать: отсеивать
заняться: займется займемся
формировать: формировать формирующие формируем формирует
окно: окон окно окне
набор: набора наборы набор набором
образ: образ образах образом
скачивать: скачивает скачивали скачивайте
начинаться: начинается
платформа: платформе платформу платформой
назвать: назовем назовите
усмотрение: усмотрение
установить: установлена установлено установлен установить установили установим
сформировать: сформируем
веб: веб
задание: задания
конструктор: конструктор конструктора конструкторах конструкторе
подавать: подаем подавали
попытаться: попытаться попытается
присваивать: присваивает присваивать присваиваем
указанный: указанной указанную указанного указанный указанными указанные
набирать: набирает
начинать: начинали начинаем начинайте начиная начинает начинал
звонок: звонка звонок
три: тремя три трех
приводить: привожу приводят приводил приводит
справа: справа
правда: правда
открываться: открывались открывается
возвращаться: возвращайтесь возвращаться возвращаетесь возвращаются возвращается возвращаемся
отображаться: отображаются отображается отображаться отображались
набрать: набран
оставаться: остается оставалось оставаться остаются
ответить: ответить
поэкспериментировать: поэкспериментировать
приставка: приставки
ругнуться: ругнется
подходящий: подходящее подходящих подходящего подходящей подходящим
сработать: сработал сработает
оставить: оставить оставили оставим
кривая: кривые
запуститься: запустится запустилась запустился запустилось
оказаться: оказались
некорректный: некорректными
отредактировать: отредактируем отредактировать
задать: заданное задан задать
оно: оно
подписываться: подписывайтесь подписывалось
заточить: заточен заточены
конкретный: конкретной конкретные конкретными конкретных конкретного конкретный конкретным
позвонить: позвонить
способный: способна способен способно способные
смена: смене смену смены смена
состояние: состояния состояний состоянии состояние состояниях состоянию
проходить: проходит проходили
существование: существования
вызываться: вызывался вызываться вызывается вызываются
фокус: фокусе фокус
прописывать: прописывать прописываем прописываете
порядок: порядка порядок порядке
выполняться: выполняется выполнялся выполняются
интересно: интересно
поведение: поведение
вспоминать: вспоминаем вспоминают
суперкласс: суперклассу суперклассом суперкласса
дописать: дописать допишем
фильтр: фильтр фильтру фильтры фильтра
прошлое: прошлому прошлого прошлым
тег: тега тегу тег
испытание: испытаниям
появляться: появляется появляться
разбираться: разбираться разбираемся
терять: теряет
переходить: переходить переходите переходя переходит переходим
затем: затем
переставать: перестает
уничтожаться: уничтожается
находиться: находиться находясь находилось находитесь находится находящаяся находился находятся
взаимодействовать: взаимодействовать
вернуться: вернется вернулись вернулось вернемся вернуться вернулся
восстановиться: восстановиться восстановилось
статус: статусе статус статусов статуса
нуль: нуля нули нулю
восстанавливаться: восстанавливается
уничтожить: уничтожен уничтожено
перейти: перешло перешел перейти
ну: ну
перевести: переведено
потерять: потерять потеряло
видимость: видимость видимостью
закрыться: закрылось
раз: раза
непонятно: непонятно
прогнать: прогнать
алгоритм: алгоритм алгоритмы
сверяться: сверяйтесь
она: ею она
достаточно: достаточно
наглядный: наглядная наглядный нагляднее
расписать: расписать расписано распишу
обязательно: обязательно
связь: связь связи
наверняка: наверняка
возникнуть: возник возникнет возникнуть
ведь: ведь
стать: станет стал станут статей стать стала станем стали стало
исключение: исключения исключений исключением
о: обо о об
слишком: слишком
заумный: заумным
камент: каменты каментам каментах каментов
фиксировать: фиксируем
старый: старых старые старой
сворачивать: сворачиваем
движение: движения
освобождение: освобождения
называть: называют называемый называемое называть называемых называли
перекрыть: перекрыто
занимать: занимают занимаемые занимала занимаемое занимает
полупрозрачный: полупрозрачно
полностью: полностью
перекрываться: перекрывается
схематично: схематично
изобразить: изобразить
упрощение: упрощения
краткий: краткое краткий
скобка: скобках
крест: крестом
обозначить: обозначил обозначить обозначена
отсутствие: отсутствия отсутствие
пользователюonresume: пользователюonresume
активность: активности
взаимодействие: взаимодействия взаимодействию взаимодействие
пользователюondestroy: пользователюondestroy
наоборот: наоборот
триггер: триггером
уведомлять: уведомляют уведомлять
эмулировать: эмулировать эмулируем
ориентация: ориентацией ориентация ориентации ориентацию
кривой: криво
знакомый: знакомы знакомое знакомый знакомо
повториться: повторюсь
поучаствовать: поучаствовал поучаствовать
пользоваться: пользоваться пользуетесь пользуемся
подсказать: подсказали
замечание: замечание
супер: супер
расположить: расположены расположили расположен
создаться: создалось создалась создался
проделывать: проделывает проделывали проделывать
обратный: обратный обратные
исчезать: исчезает
вести: вести ведут ведет
смениться: сменилась
казаться: кажется
особенный: особенного
процедура: процедуры процедура
восстановление: восстановления
про: про
шаблонный: шаблонное
объяснение: объяснениях объяснения объяснение
недостаточно: недостаточно
понятный: понятен понятный понятной понятнее понятным понятна
раскрыть: раскрыть раскройте
советовать: советую
хелп: хелпе хелп хелпа хелпом хелпу
усвоиться: усвоятся
кодить: кодить
войти: войти вошла
логин: логин
пароль: пароль пароля
повтор: повтор
электронный: электронной
почта: почт почты
подтверждение: подтверждения подтверждение
из: из
простейшее: простейшее
фамилия: фамилию
отправка: отправки отправке отправка
помнить: помните помним
знакомство: знакомство
напомнить: напомню
подчеркнуть: подчеркнутый подчеркнуто подчеркнут
красный: красные красным красной
мешать: мешает мешают
чуть: чуть
множество: множество
вариация: вариаций
аналогичный: аналогичное аналогичны аналогичной аналогичен аналогичный
ключ: ключ ключи ключом
отправить: отправить
укомплектовать: укомплектованный
вывод: выводу вывод выводе вывода
точно: точно
явный: явный явным явная явного
пожелать: пожелаете
вывести: вывело выведет вывести выведем вывел
многообразие: многообразие
возврат: возвратом возврата возврат
обновлять: обновляем обновлять
бд: бд
структура: структуру структура структурой структуре структуры
развитие: развитием
необходимость: необходимость необходимости
упоминать: упоминал
существующий: существующий существующая существующих существующее существующие существующему
отличаться: отличается отличаться отличаются
подключиться: подключиться
переход: перехода переход
сотрудник: сотрудников сотрудника
должность: должностями должностью должностей должность должности
корректный: корректна
зарплата: зарплатам зарплатой
курсор: курсорами курсор курсора
иван: иван
марья: марья
пётр: петр
антон: антон
даша: даша
борис: борис
костя: костя
игорь: игорь
программер: программер
бухгалтер: бухгалтер
директор: директор
охранник: охранник
сгруппировать: сгруппировал
операция: операции операций операцию
подключаться: подключаться подключаемся подключается
отключаться: отключаемся
вывестись: вывелись
около: около ок
внезапно: внезапно
проектирование: проектировании
допустить: допущена допустим
записывать: записываем записывает записывать
неправильно: неправильно
добавляться: добавляется добавлялись добавляются
надо: надо
скрипт: скрипт скрипты
потеря: потери
план: планом плане план планы
столбец: столбца столбцом столбец столбцам
удалять: удаляет удаляем удалять
ориентировать: ориентированном ориентировано
объединение: объединения
нюанс: нюанс нюансов нюансы
транзакция: транзакции транзакций транзакцией транзакцию транзакциям транзакция
накатиться: накатились
отменить: отменены отмененный отменить
прежний: прежними прежней
выручать: выручают
приходиться: приходится
временной: временную временной
перекидывать: перекидывать
оригинал: оригинал
скидывать: скидывать
почитать: почитать почитал
обновиться: обновилось обновились
поставить: поставим поставьте поставили поставить поставил поставит
свежий: свежий
смартфон: смартфоне смартфоном смартфона смартфон
присвоить: присвоить присвоен присвоили присвоены присвоим присвоит
обновить: обновить обновлю обновлен обновил обновите обновим обновленную
заполнение: заполнение заполнения
корректно: корректно
отработать: отработает отработан отработал отработать
формат: формате формат формата форматах
сценарий: сценарий сценарии
выдумать: выдуманы выдуманный
придраться: придраться
поспорить: поспорить
запросить: запросить запросило
поначалу: поначалу
показаться: покажется
запутать: запутанным запутал
реально: реально
опыт: опыт опытом опыте опыта
отметить: отмечено отмеченные отметить отметил
освобождать: освобождаем освобождает
смело: смело
основательно: основательно
дальнейший: дальнейших дальнейшем
свободно: свободно
перед: перед
вспомнить: вспомнив вспомним вспомнить
перебирать: перебираем перебирать перебирали
массив: массивах массива массиве массив массивов
итерация: итерации
пункт: пункта пункте пункт пунктах пунктом пункты пунктами пунктов пунктам
адаптер: адаптер адаптеры адаптеров адаптерам адаптеру адаптера
анна: анна
денис: денис
андрей: андрей
вы: вами вы вам
поверить: поверите
контекстandroid: контекстandroid
представлять: представляет представляют
проматывать: проматывайте
низ: низ
двойной: двойным двойной
клик: кликом клик
формирование: формирования формировании
очередной: очередной
прогонять: прогоняет
преобразовать: преобразует преобразуем
однако: однако
устраивать: устраивает
цвет: цвета цвет цветом цвете цвету цветов
размер: размера размер размере размеров размеры размеру размерами
шрифт: шрифта шрифт шрифты шрифтов
выравнивание: выравнивания выравниванию выравниванием выравнивание
отступ: отступа отступом отступы отступ отступов
зелёный: зеленая зеленый зеленым
производный: производный
преобразование: преобразование
отдать: отдаст
контекст: контекста контекст
базовый: базовым базовое базовых базовый
недоступный: недоступна недоступен
восходящий: восходящую
без: без
одиночный: одиночный одиночного
множественный: множественным множественный множественного
группировать: группируем группировать
сортировать: сортируем
идентификатор: идентификатор идентификатора
последовательность: последовательности последовательность
показ: показ показе показа показом
чтоб: чтоб
уточнить: уточню
андроид: андроиде андроида андроид
включить: включите включили включит включенном включен включить
стереть: сотрем
стоить: стоит
галка: галки галку галка
обработка: обработку обработки обработка
импорт: импорта импорт импорте
отображение: отображение отображения отображении отображением
вносить: вносить вносим
объединить: объединены
визуально: визуально
никак: никак
проявляться: проявляется
позиция: позиции позиция позицию
сортировка: сортировка сортировку сортировок
возрастание: возрастанию
малый: меньшего
больший: большего большему большей
передаваться: передается
скрывать: скрывать
выключить: выключен выключена
отсортировать: отсортированы
совпадать: совпадать совпадают совпадает
размещаться: размещаются
срабатывать: срабатывает срабатывают
сверить: сверить
кодиля: кодили
удобство: удобства
шесть: шести
напрямую: напрямую
цифра: цифрами цифры
рекомендоваться: рекомендуется
предпочтительный: предпочтительный
программно: программно
правый: правый правую правая правее правой правому
экранный: экранном экранные экранных
вручную: вручную
связать: связаны связана свяжем
согласно: согласно
скрыть: скрыть
опробовать: опробуйте опробуем опробовать
потестить: потестить
программный: программное
гибкий: гибче гибок
сокращать: сокращает сокращаем
контекстный: контекстное контекстные контекстного контекстных
рассказывать: рассказывать рассказывал рассказываю
современный: современных
устройство: устройстве устройств устройство устройства устройствах
переехать: переехало
скриншот: скриншотов скриншоте скриншоты
устареть: устарела устарели устарело
актуальный: актуальны актуальна
за: за
отвечать: отвечает отвечают
условие: условия условиями условии условий
поручать: поручаем
зваться: зовется
всплывать: всплывающее всплывающие всплывало
формироваться: формируется
помещаться: помещается
доставаться: достается
перевод: перевод
основной: основной основные
письмо: писем письмо письма
почтовый: почтовой почтовое
уходить: уходит
ощущение: ощущение
рамка: рамках
бесшовность: бесшовность
достигаться: достигается
счёт: счет
прежде: прежде
продолжить: продолжить продолжу продолжим
лёгкий: легче
аналог: аналоги аналог
организация: организации организацией
схожий: схож
навигация: навигация навигацией навигации навигацию
предыдущий: предыдущую предыдущих предыдущего предыдущее предыдущем
вперёд: вперед
отсутствовать: отсутствует
стираться: стирается
попасть: попадут попасть попадет
большинство: большинства большинство большинстве
задний: задний заднем
фон: фон фона фоне
активный: активной активном активная
передний: переднем передний
таков: таков таковы такова
история: историей
посещение: посещений
определённый: определенными определенному определенного определенным определенное определенную определенном определенные
стартовый: стартовая стартовое
домой: домой
ярлык: ярлык
корневой: корневое корневой корневого
выходить: выходит выходим
обнаружить: обнаружит обнаружила
верх: верху верх верха
топ: топ топе
удаляться: удаляется
оказываться: оказывается
содержаться: содержатся
специально: специально
сортироваться: сортируются
упорядочиваться: упорядочиваются
стэк: стэке стэк стэка
офица: офиц
демонстрировать: демонстрировал демонстрирует
верхний: верхнего верхний верхнему верхнем верхняя верхнее верхние верхней
нижний: нижнее нижнюю нижнему нижняя нижней нижний
уйти: ушел уйдет ушли
оттуда: оттуда
корнев: корневым
удерживать: удерживать
ов: ов
удалённый: удален удаленных
остановиться: остановимся остановиться остановился
дебри: дебри
полезть: полезем
вставиться: вставились вставилось вставилась
поймать: поймать
добиться: добиться
диалоговый: диалоговый
режим: режима режимы режимах режим режиме
лишь: лишь
разница: разницу разница
нормальный: нормальный нормальные
зайти: зайдите зайти
поиграться: поиграться
закрепить: закрепить закрепим закрепите
неявный: неявного неявный
трудность: трудностей
примерно: примерно
уложиться: уложилась
голова: голове
инф: инфа инфу инфы
объяснить: объясню объяснить
подкласс: подкласс подклассом
вкратце: вкратце
явно: явно
легко: легко
выдать: выдало выдаст
любезно: любезно
подсказывать: подсказывает подсказывать
предел: пределах пределы
комбинация: комбинация комбинации комбинацию
цель: целей цель
достигнуть: достигнем достичь
гиперссылка: гиперссылки
зависеть: зависит зависят
заполняться: заполняются
отправляться: отправляется
сверять: сверяет сверяют
найтись: нашлась найдется нашлось нашелся нашлись
выводиться: выводится
музыкальный: музыкальных
плеер: плееров
играть: играть
музыка: музыку
редактить: редактить
звонить: звонить
проигнорировать: проигнорированы проигнорировано
проводить: проводить проводили проводит
замок: замком
сидеть: сидит
прекрасный: прекрасное
постепенно: постепенно
узнавать: узнавать
посылать: посылает посылали посылаем
применяться: применяется
вводный: вводных
донести: донести
технология: технологий технологии
практиковаться: практиковаться
перегрузить: перегруженными
перечитать: перечитать
реализовывать: реализовывать
подтверждать: подтверждаем подтверждать
основать: основан
функционал: функционалу функционала функционал
настраивать: настраивать настраивали настраиваем
справиться: справиться
задача: задачей задачу задач задача задачи
реализоваться: реализуется
дата: даты дату датой
прямой: прямое
строковый: строковая
производиться: производится
перечислить: перечислил перечислить
успех: успехом
отражать: отражает
префикс: префикс
коллизия: коллизий
пересекаться: пересекаться
выделять: выделяли выделяйте выделяем
детально: детально
вычислять: вычисляем
проделать: проделаем
кой: кое
спровоцировать: спровоцируем
совершенно: совершенно
одинаковый: одинаковы одинаковые одинакова одинаков
отличие: отличие отличиями отличия
пофиксим: пофиксим
диалог: диалог диалоги
значительно: значительно
отлично: отлично
запутаться: запутались
скрин: скрин скринов
тестировать: тестировал тестируете тестировать
уровень: уровня уровни уровень уровне уровню уровней
важность: важности
убывание: убыванию
кружка: кружках
высокий: высокая высокой
несложно: несложно
записать: запишут запишем
тэг: тэгов тэги тэг тэга
метка: метки метку метка
спросить: спросит
понажимать: понажимаем понажимать
записаться: записалось записалась
значок: значок
произвольный: произвольными произвольную произвольное
иногда: иногда
открыться: открылась откроется открыться открылся
кликнуть: кликнуть кликните
подредактировать: подредактируем
синтаксис: синтаксис
статический: статический статическим статические
вдаваться: вдаваться
продолжительность: продолжительность
подобный: подобные подобный
размещение: размещение размещении размещением размещению размещения
размещать: размещаем размещать размещаю
нововведение: нововведение
панель: панель
иконка: иконкой иконку иконками иконки иконка
ранний: раньше
строить: строим строил
случайно: случайно
актуально: актуально
особо: особо
ранее: ранее
хватать: хватает
свободный: свободного свободна свободное свободной
влезть: влезут влез влезет
точка: точек точку точки точкам
скрытый: скрытые скрытая
увеличить: увеличим
повернуть: повернуть повернете повернем
горизонтальный: горизонтальную горизонтальная горизонтальный горизонтальных горизонтальной
местечко: местечко
вылезти: вылез
сказываться: сказывается
несмотря: несмотря
добраться: добраться
планшет: планшете
судить: судя
долгий: долгое долгим долгого
сюда: сюда
трогать: трогать трогаем трогая
кликабельный: кликабельна
задействовать: задействовать
насколько: насколько
назначение: назначению назначение
коренной: коренное
действительно: действительно
логический: логический логической
вверх: вверх
предлагаться: предлагается
вешать: вешать
стрелочка: стрелочку
стрелка: стрелка стрелкой
изображение: изображения изображение
напоследок: напоследок
заголовок: заголовков заголовке заголовок заголовку
подзаголовок: подзаголовок
новость: новость новости
обозначать: обозначаем
ловить: ловить ловит
ответ: ответа ответ
пересоздать: пересоздали
очепятка: очепятка
июль: июля
август: августа
сентябрь: сентября
октябрь: октября
ноябрь: ноября
декабрь: декабря
январь: января
февраль: февраля
март: марта
апрель: апреля
май: мая
июнь: июня июне
секция: секцию
поручить: поручит поручим
продолжать: продолжает продолжаем продолжаю продолжала
подчёркивать: подчеркивает
решить: решил решите решить решили
скормить: скормить
потом: потом
проговорить: проговорю проговорим
слушатель: слушателем слушателя
кнопкея: кнопкеи
выступать: выступать выступает
шейдёр: шейдеры шейдера шейдере шейдером шейдер шейдеров
треугольник: треугольник треугольника треугольником треугольников
закрасить: закрасили
коснуться: коснулись коснулось
основный: основным основных основного основное
язык: языке языком язык
графика: графике
строиться: строится
графический: графическим графические графическое графических графического графический
примитив: примитивы примитив примитива примитивов
процессор: процессором процессора процессор
вершина: вершины вершинами вершин вершине вершинах
заливка: заливки
вершинный: вершинного вершинном вершинный вершинные
оперировать: оперируют
фрагментный: фрагментные фрагментным фрагментный фрагментного фрагментном
окончательный: окончательные
от: от
копия: копию
похожий: похож похожа
вектор: вектор
трёхмерный: трехмерные
передача: передачу передача передачи передаче
собраться: собрался собрались
положение: положения положении положение
влиять: влияет влияют влияем
входной: входными входные
транслировать: транслирует
устанавливать: устанавливали устанавливайте устанавливать устанавливает устанавливаем
точность: точности точность
вычисление: вычислений
ниже: ниже
дефолт: дефолту
расчёт: расчета
подходить: подходит
задавать: задают задаете задавать задает задавали задаем
одинаково: одинаково
фрагмент: фрагменту фрагментами фрагмента фрагментах фрагментом фрагментам фрагменте фрагмент фрагменты фрагментов
обработать: обработать обработаны
рисование: рисование рисования рисовании
вещь: вещей вещах вещь вещи вещью
заработать: заработало заработали
входящий: входящие
текстовый: текстовыми текстовое текстовом текстового текстовых
вникать: вникать
изменяться: изменяться
протяжение: протяжении
логика: логику логика
подготовка: подготовке
поверхностно: поверхностно
удаться: удался удалось удалась
ассоциировать: ассоциирует
компилировать: компилирует
индекс: индекса индексом
успешно: успешно
иначе: иначе
связка: связка связке
одиночка: одиночке
итоговый: итоговой
объединять: объединяют
аттачить: аттачим
приаттаченный: приаттаченных
шейдерный: шейдерному
серьёзный: серьезные серьезная
подготовить: подготовлены подготовим
ставить: ставим ставили ставит
чёрный: черном черным
дефолтный: дефолтный дефолтным дефолтные
очистка: очистки очистка
поверхность: поверхность
подготавливать: подготавливаем
ти: ти
канва: канвой
диапазон: диапазона диапазону
ширина: ширине шириной ширину ширины ширина
высота: высота высотой высоту высоте высоты
учитывать: учитываем учитывайте учитывает
сконвертить: сконвертить
буфер: буфера буфер
байт: байтов байта байт
кол: кол
вникнуть: вникнуть
синий: синяя синего синий
шейдрать: шейдеру
правило: правила правил правило
флаг: флаг
неактуальный: неактуален
буффера: буффер
идея: идее
послать: послать
вызваться: вызвался
очищать: очищаем очищает
поменять: поменяли поменять поменяем поменяйте
рендёр: рендера
накодиля: накодили
разбить: разбить
унывать: унывайте
норма: норма
текстура: текстуры
гораздо: гораздо
адресат: адресата
абонент: абонента
обращать: обращаем обращайте
закрываться: закрывается
идентификация: идентификации
положить: положил
адресовать: адресуем адресовать
успешный: успешного успешное успешной
завершение: завершения завершение
передаться: передастся
завершать: завершаем
подытожить: подытожить
поместиться: поместилось поместится
приём: приемы прием
распаковать: распаковали
показательный: показательный
таба: табами табы
выпадать: выпадающего выпадающий выпадающем выпадающим
добавление: добавлении добавление добавления
удобно: удобно
совершение: совершения
удаление: удаление удалении удаления
пересылка: пересылка
табов: табов
таб: таб
развыбрать: развыбран
перевыбрать: перевыбран
логично: логично
перегружать: перегружать
подразумеваться: подразумевается
предупреждать: предупреждает
полоса: полосой полосы полосу полоса
нехватка: нехватке
вниз: вниз
храниться: хранятся храниться
суффикс: суффиксами
предназначить: предназначены предназначена
свойство: свойстве свойствами свойство свойства свойств
уникальный: уникальных уникальным
снизу: снизу
прозрачный: прозрачен прозрачно
раздельный: разделен
половина: половину половины половина половине
фоновый: фоновый фоновые фоновых
редактор: редактор редакторе
вставить: вставленной вставим вставить вставлены вставьте
заглянуть: заглянем
ветка: ветке
только: только
выражение: выражения выражение выражений
разделять: разделять
следовать: следует следовать
рекомендация: рекомендации
сквозной: сквозные
угодный: угодно
приходить: приходит
отличать: отличать
обратно: обратно
цвета: цветами
завершить: завершена завершить
ожидание: ожиданием
обозначение: обозначение обозначения
окончание: окончания окончании
равно: равно
белый: белый
наступить: наступить
вправо: вправо
неудачно: неудачно
ограничение: ограничений ограничение
общепринятый: общепринятые общепринятый
подвести: подведем
род: роде
проверяться: проверяется
рабочий: рабочем рабочий рабочие
изменять: изменяем изменять
вес: вес веса
регулятор: регулятор
ползунок: ползунок ползунка
регулировать: регулировать
пространство: пространство пространства
прокрутка: прокрутка прокрутки прокрутку
выкрутить: выкручен
максимум: максимума максимум
поровну: поровну
делить: делят
обязать: обязаны обязана
тащить: тащить тащите тащим
отпускать: отпускаем
перетаскивание: перетаскивания перетаскиванием перетаскивании
слева: слева
вычесть: вычесть
чем: чем
подача: подачи
перетаскивать: перетаскивать перетаскивая
эффектно: эффектно
заметить: замечено заметить заметим заметили заметите
перерисоваться: перерисуется
осмыслить: осмысленное осмысленными
калькулятор: калькулятор
чистота: чистоты
динамический: динамический динамическое динамическая динамическим динамической
привычный: привычнее привычного
контейнер: контейнере контейнер контейнера
среагировать: среагировали
привыкнуть: привыкли
прокатить: прокатит
вызывающий: вызывающая
дорисовать: дорисуем
разместить: размещен разместим
достучаться: достучались
разряд: разряд разряда
кэп: кэп
ссылаться: ссылаться ссылается ссылаются
динамически: динамически
поработать: поработать
маловатый: маловат
фишка: фишка фишки
неинтересный: неинтересны неинтересно
обособленный: обособленный обособленным
проинформировать: проинформировать
отвлечься: отвлекусь
лирический: лирическое
отступление: отступление
модульность: модульность
универсальность: универсальности
удобность: удобности
лёгкость: легкости
рецепт: рецептов
чисто: чисто
технический: технические
организовывать: организовывать
целое: целом целое целого
форум: форум форумом форуме форума
ломиться: ломился
излагать: излагал
видение: видение
спор: споров
сторона: стороны сторона сторон
крокодил: крокодил
нифига: нифига
длинный: длинном длинный
сообщить: сообщить сообщит
известный: известные известная
распространить: распространенная распространенные распространенный
присоединить: присоединен
дописывать: дописываем
вставлять: вставляли вставляем вставлять вставляемыми
парсим: парсим
парсер: парсеру парсер
разбор: разбора
заключаться: заключается
пробегать: пробегает
аттрибут: аттрибутов аттрибутами аттрибуты
цена: цене цена
характеристика: характеристиках характеристики
возможный: возможная возможные возможны возможных
корпус: корпуса
реальность: реальностью
цикл: цикла цикл цикле
прогон: прогон
обеспечиваться: обеспечивается
дерево: дереве
глубина: глубину глубина
вытаскивать: вытаскиваем
вытаскивание: вытаскиванию
неведомый: неведомым
наблюдать: наблюдать наблюдали наблюдаем
фабрика: фабрику фабрики
укоротить: укороченный
блог: блог
берлин: берлине
течение: течение
сталкиваться: сталкиваетесь сталкивался
алгоритмический: алгоритмическими
задачка: задачками
пост: поста посте пост постов
год: годом лет году
довестись: довелось
европейский: европейской
компания: компании
поделиться: поделюсь поделиться
европа: европе
германия: германии
операционный: операционная операционную операционной
устроить: устроена
популярный: популярный популярная популярных
сервер: сервером сервер сервера
бета: беты
расстояние: расстоянии расстояния расстояние
угол: угол угла углом углами
проскакивать: проскакивает
спрашивать: спрашивающий спрашиваем спрашивали спрашивает спрашивал
подразумевать: подразумевает
рефрешнуть: рефрешнуть
правильный: правильным правильными правильнее
давно: давно
развить: развить
предложить: предложит предложат предложенных предложить
побывать: побывать
конференция: конференции
впечатление: впечатления
часто: часто
избавиться: избавились избавиться
копипаста: копипасты
описываться: описывается
запутывать: запутывающих
реклама: реклама рекламы
соц: соц
сеть: сетях сетью сети
платный: платное платных
рекламный: рекламного рекламных рекламные
телеграм: телеграм
путать: путать путайте
дополнительно: дополнительно
продублировать: продублирую продублирован
фейсбук: фейсбук
релевантный: релевантным
допустимый: допустимы
ооп: ооп
прочий: прочие прочих
программирование: программированию программирования программировании
относиться: относится относящиеся
недопустимый: недопустимы
публикация: публикациям публикаций публикации
криптовалюта: криптовалюты
блокчейн: блокчейн
коронавирус: коронавирус
азартный: азартные
игра: игры
ставка: ставки
токсичный: токсичные
провисеть: провисит
двое: двое
сутки: суток
лента: ленте
неделя: недель неделю неделе неделя
заранее: заранее
статистический: статистические
привязать: привяжем привязано привязаны привязана привязали привязать привязан
число: числа числами число числу
подписчик: подписчикам подписчиков
торг: торг
уместный: уместен
обсуждаться: обсуждается
индивидуально: индивидуально
вк: вк
фб: фб
участие: участие
бесплатный: бесплатном бесплатны бесплатен бесплатный
информационный: информационном
партнёрство: партнерстве
взаимопиар: взаимопиарах
баннер: баннеры
недавно: недавно
незаслуженно: незаслуженно
скрытие: скрытие
более: более
убрать: уберут уберу убрать убрали убрав
чекбокс: чекбоксы чекбокс чекбоксов чекбокса чекбоксе
поочерёдно: поочередно
перерисовка: перерисовка
играться: играться
вадим: вадим
ольга: ольга
сергей: сергей
перечислять: перечислять
заменить: замените заменили заменит заменить
снимать: снимали
выделение: выделение выделения
марьяантонкостя: марьяантонкостя
пачка: пачку
откатить: откатить
исследовать: исследуем
вставка: вставки вставка вставке
управление: управления
поправимый: поправим
чистить: чистим
закрытый: закрыто закрыта закрытый закрыт закрыты
отмениться: отменятся
исправиться: исправимся
успешность: успешности успешность
блокировка: блокировок блокировку блокировкой
подключение: подключение подключения подключениям подключении подключением подключений
попытка: попытка попытке
заблокировать: заблокирована
открытый: открытое открытой
закоментит: закоментите
записываться: записывается
открытость: открытость
оттого: оттого
эффект: эффект
обнулить: обнулит
гарантировать: гарантировано гарантирует
соединение: соединение
обнуляться: обнуляется
источник: источника источниках
цитата: цитата
планировать: планируете планирую планируем планировали
блокироваться: блокируется
старший: старше
подозревать: подозреваю
желание: желание
погрузиться: погрузиться
форма: форм форму форма
неуспешный: неуспешными
осилить: осилить
ход: ходу
создатель: создатели
дремать: дремлют
объявить: объявили
устаревший: устаревшим устаревший устаревшими устаревших
переделывать: переделывать
таки: таки
осветить: осветить
встроить: встроен
управлять: управляет управлять
уничтожать: уничтожает уничтожать
останавливать: останавливает останавливать останавливаем
колбэк: колбэка колбэк
лоадер: лоадеру лоадером лоадер лоадере лоадеров лоадера лоадеры
учёт: учетом
короткий: короткий коротком
ом: ом
прикрутить: прикрутить
пауза: паузу паузой паузами
сечь: сек
долго: долго
расширять: расширяет
параметризировать: параметризированным
старт: старт старте
остановка: остановки остановке
формулировка: формулировкой
остановить: остановлен
словесно: словесно
идентифицировать: идентифицировать
неактивный: неактивным неактивной
уничтожение: уничтожении уничтожение
оповещать: оповещает
окончить: окончена
различать: различать
пояснить: поясню
аж: аж
успеть: успел
отправиться: отправится
почти: почти
хэш: хэш
свернуть: свернем свернуть
полудняonloadfinished: полудняonloadfinished
полдень: полудня
честно: честно
никто: никому
дождаться: дождаться дождемся
переключить: переключим
н: н
э: э
отрабатывать: отрабатывает
переводиться: переводится
старое: старого
проигнорный: проигнорен
девайс: девайс
уведомление: уведомления уведомление
действовать: действует
ставиться: ставится
одновременно: одновременно
сбрасывать: сбрасываем
поставиться: поставилась
интерес: интерес интересы
переделать: переделать
убить: убить
вышесказанный: вышесказанное
упрощённый: упрощенной
возиться: возиться
переопределять: переопределять
логировать: логировать
минимальный: минимальные минимальны минимальная минимальную
внешне: внешне
отмена: отмена отмены
задержка: задержку
последовательный: последовательной последовательными
мсек: мсек
отсчитать: отсчитает
переключаться: переключайтесь переключается
ящик: ящике ящика
перемещаться: перемещаться перемещаетесь
сущность: сущность
усложнять: усложнять
наверно: наверно
термин: терминами
надпись: надписи надпись надписей
зона: зоны
пройтись: пройдемся
представление: представление представления
открыто: открыто
мало: мало
рядом: рядом
контур: контуры
переключать: переключать
прогрессбар: прогрессбары
прочее: прочее
вложить: вложен вложим вложенные вложенным вложенных вложенный
речь: речь
пожалуйста: пожалуйста
прочтение: прочтения
уехать: уедет уехали уехал
автозаполнение: автозаполнение
мышка: мышкой
русский: русскими русском русских
любоваться: любуемся
ракурс: ракурса
вертикальный: вертикальный вертикальной вертикального вертикальную вертикальная
штатный: штатное
расписание: расписание
работник: работников
параллельно: параллельно
тройка: тройки
обеспечить: обеспечит
оклад: оклад
ву: ву
раскрашивать: раскрашиваем
затруднительно: затруднительно
классический: классический
облегчить: облегчит
ясно: ясно
заменять: заменяем заменять
манипуляция: манипуляции
отменять: отменяем отменять
наследовать: наследовать наследующие наследует наследующий
замена: замены
включение: включения
менеджер: менеджер
производить: производим
удалиться: удалился удалится
подать: подать
замениться: заменился заменится
стек: стеке стек стека
закончиться: закончится закончатся
самостоятельный: самостоятельной
удивить: удивит
определимый: определим
символ: символы символа символов
отдельность: отдельности
посимвольный: посимвольные посимвольно посимвольная
отмечать: отмечая
реальный: реальных реальный реальной реальное реальная
урезанный: урезанного
лимит: лимит лимита
ограничивать: ограничивать
точный: точную точного точная
попадать: попадает
выяснить: выяснил выясним выяснили
занять: займет займут заняли
среди: среди
измерение: измерения
прямоугольник: прямоугольник
заключить: заключен
моноширинный: моноширинный
засечка: засечками
жирный: жирный
курсивный: курсивный
разновидность: разновидности
форматирование: форматирования
растянутый: растянутый
наклонить: наклоненный
зачеркнуть: зачеркнутый
растянуть: растянуть
сжать: сжать
наклон: наклон
раскидать: раскиданы раскидать
длительный: длительным
однородный: однородных
доп: доп
перечисление: перечислением
группировка: группировок группировку группировка
долг: долгом
расширение: расширения расширений
кругозор: кругозора
сложноватый: сложноватым
страшный: страшного
мысль: мысли
вслух: вслух
принадлежать: принадлежит
равнозначный: равнозначна
сконфигурировать: сконфигурировано
запомнить: запомнили запомните запомнить
берет: берете
заглавный: заглавные
буква: буквами буквы
подчёркивание: подчеркивание
плюc: плюc
подставить: подставить подставим
инструкция: инструкцию инструкций
применять: применяйте применять применяете
сопоставляться: сопоставляется
одноимённый: одноименный
наследник: наследником наследник
накодим: накодим
запрашиваться: запрашивалось
мышь: мыши
любитель: любителей
горячий: горячих
клавиша: клавиши клавиш
визард: визардом визард
изначально: изначально
подтвердить: подтвердить
предпросмотр: предпросмотр
читабельный: читабельное
скопировать: скопировать скопируем
бегать: бегать
рука: руками
включиться: включится
ряд: ряд ряда
влезать: влезают
горизонтально: горизонтально
подумать: подумал подумали
спецификатор: спецификатор спецификаторов спецификатора
юзать: юзать
сверху: сверху
адекватно: адекватно
присутствовать: присутствует
смущать: смущает
до: до
четыре: четыре
распространяться: распространяются
править: правим
край: края край краю краями краем
пиксел: пиксел пикселах
выравнять: выравнен выравнены выравнена
вероятно: вероятно
попрактиковаться: попрактиковаться попрактикуемся
установка: установка установку установки
вестись: ведется
гуглита: гуглите
перезагрузить: перезагрузить
гугл: гуглом гугл
специфический: специфическая
весить: весить
гиг: гигов
заменимый: заменим
каталог: каталог
диск: диска диском
начаться: начнется
пуск: пуск пуске
импортировать: импортировать
загрузить: загруженные загружен загрузить
распаковка: распаковки
погуглить: погуглить
периодически: периодически
клянчить: клянчить
новичок: новички новичков новичок новичкам
вряд: вряд
новшество: новшеств новшества
немалый: немалые
подключать: подключать
охватывать: охватывает охватывают
подтема: подтемы
сочетание: сочетание
отслеживать: отслеживать отслеживает
живой: живыми
обёртка: обертку обертка
постраничный: постраничной
избавить: избавит
обсуждать: обсуждать обсуждаем
теоретический: теоретических
поразбирать: поразбирать
выразить: выразить
благодарность: благодарность
яндекс: яндекс
сотня: сотни сотня
выйти: вышел вышла выйдет
сборник: сборнике
книжка: книжка
оглавление: оглавление
закладка: закладок
крупный: крупный
смс: смс
ярослав: ярославу
звать: зовут
гаджет: гаджеты
спорт: спорт
специализация: специализацией
сфера: сферы сфере
продукт: продуктов
основное: основном
интеграционный: интеграционной
шина: шиной
зацепить: зацепил
москва: москве
консалта: консалта
контора: контор
русало: русал
лукойл: лукойл
лореаля: лореаль
сабмиллер: сабмиллер
евросеть: евросеть
мвидео: мвидео
берлинский: берлинской
немало: немало
оценить: оценить
реквизит: реквизиты
поддержать: поддержите
навык: навыках
помимо: помимо
стараться: стараться стараюсь
личный: личном
фильм: фильмы
настраиваться: настраивается
относительно: относительно
перетащить: перетащили перетащить перетащите
выстроиться: выстроились
вертикально: вертикально
вкладывать: вкладывать
напоминать: напоминаю
столбцы: столбцов столбцы
определяться: определяется определяться
максимальный: максимальным
вом: вом
ничто: ничем
лечь: легли
широкий: шире широкому
построить: построю
упражнение: упражнения
растянуться: растянулась растянется
выравненный: выравненным
центр: центре центру
кратко: кратко
незнакомый: незнакомых незнакомые
опускать: опускать
абсолютный: абсолютные абсолютных абсолютное
максимально: максимально
отказываться: отказываться
совместимость: совместимость совместимости
впритык: впритык
подобавлять: подобавлять
частый: чаще
статичный: статичны
будущее: будущего будущем
обеспечивать: обеспечивает
позиционирование: позиционирование
выстраиваться: выстраиваются
ложиться: ложатся
наиболее: наиболее
интуитивно: интуитивно
располагаться: располагаться располагалось располагаются
разрабатывать: разрабатываете
сместиться: сместятся
будущий: будущими
гарантироваться: гарантируется
осваивать: осваивать
ограничить: ограничен
структурировать: структурированных
неудобный: неудобен
первичный: первичной
апдейтить: апдейтить
фраза: фраза фразе
устаревание: устаревания
накидать: накидаем
справочник: справочник
да: да
освоить: освоить
выборка: выборки выборке
минимум: минимуме минимум
заполниться: заполнится
заодно: заодно
выбраться: выбралось
порядковый: порядковые
добираться: добираемся
очистить: очистим
реал: реале
тормозить: тормозило
гравитация: гравитация
физический: физическому физические
противоположный: противоположными
измеряться: измеряется
дюйм: дюйма дюйме дюймах дюйм
горизонталь: горизонтали
вертикаль: вертикали
пиксель: пикселей
классика: классику
вмещать: вмещаемое
еи: еи
миллиметр: миллиметр
различие: различиях
соотношение: соотношениях
независимо: независимо
занимета: занимет
распределяться: распределяется
пропорционально: пропорционально
сосед: соседа
делёж: дележом
поделить: поделили
единица: единицы
четверть: четверть четверти
проставлять: проставляем
претендовать: претендуют
забирать: забирает
учитываться: учитываться
коэффициент: коэффициентам
продемонстрировать: продемонстрируем продемонстрировать
выстраивать: выстраивает
демонстрация: демонстрации
очевидный: очевидно
сведение: сведения
повод: поводу
экспериментировать: экспериментировать
образоваться: образовался образуется
дизайн: дизайна
моделирование: моделирования
вёрстка: верстки
слышать: слышали
каскадный: каскадные
параграф: параграфов
рисоваться: рисуется
повторять: повторять
заморачиваться: заморачиваться
набраться: наберетесь
разъяснять: разъясняет
сложение: сложения
вычитание: вычитания
умножение: умножения
деление: деления
запятая: запятую
пустота: пустоту
ноль: ноль
анимация: анимацию анимация
добрый: добрый
побудить: побудили
официальный: официального официальном
двигаться: двигаться
зря: зря
наткнуться: наткнулся
многое: многое
спина: спиной
непонятный: непонятным непонятных
постараться: постараюсь
независимый: независимым
просматривать: просматривать
лишний: лишний лишнего
подбирать: подбирать
час: часа
невозможно: невозможно
базис: базис
изложить: изложенной изложенное
руководство: руководство
пренебречь: пренебречь
упустить: упустить
единственно: единственно
замечательный: замечательный
рад: рад
спамер: спамеров спамер
контрольный: контрольным
зарегиться: зарегиться
пять: пять
вынужденный: вынужденного вынужденная
защита: защита
зато: зато
проникнуть: проник
парсинга: парсинг
асинхронность: асинхронность
сервис: сервисе сервисом сервиса сервис сервисы сервисов сервису
касание: касаний
мультитач: мультитач
виджет: виджеты
подпись: подпись
воспроизведение: воспроизведение
звук: звука
видео: видео
камера: камерой
сенсор: сенсоры
развиваться: развиваться
востребовать: востребованные востребованными
рынок: рынке
клоун: клоун
зомбоящик: зомбоящика
смежный: смежных
выпускать: выпускает
кардинально: кардинально
актуализировать: актуализировать
критично: критично
посыл: посыл
работоспособность: работоспособность
звучать: звучат
высказывание: высказывания
чудик: чудик
любить: люблю
комментировать: комментировать
чушь: чушь
высказать: выскажу
мнение: мнение
дилетантство: дилетантства
подавлять: подавляющее подавляющем
доля: доля
х: х
целый: целый
киписать: кипиша
устаревать: устаревают
ужас: ужас
тяжко: тяжко
отслеживание: отслеживание
фикс: фикс
гуглохелп: гуглохелп
разве: разве
секретный: секретный
суть: сути
деталь: детали
прохождение: прохождения
освоиться: освоитесь
подпапка: подпапках подпапке
составиться: составился
нормально: нормально
волноваться: волнуйтесь
подгрузить: подгрузить
подсказка: подсказки
выключать: выключайте
прогресс: прогресс
бар: бар
подождать: подождать
касаться: касался
непосредственно: непосредственно
шаблон: шаблон
конфига: конфиг
шнур: шнуром
драйвер: драйверами
фактор: фактор
вплоть: вплоть
минута: минут
поздравлять: поздравляю
впереди: впереди
многие: многие
предупредить: предупредить
вовсе: вовсе
безнадёжно: безнадежно
редко: редко
объявляться: объявляются
обратиться: обратиться
прописываться: прописывается
чёткий: четкий
подсмотреть: подсмотреть
выложить: выложил
скорый: скорей
автоматический: автоматического
предок: предок
галочка: галочка
сегодня: сегодня
деятельность: деятельность
лямбда: лямбда
оператор: оператор оператора операторы операторов
объединениять: объединенияв
выяснять: выясняем
уже: уже
четверг: четверг
призвать: призван
мск: мск
перерыв: перерыва
ошибоква: ошибокв
перезапустить: перезапустить
зрение: зрения
практически: практически
раскрывать: раскрывает
сold: сold
наступать: наступающим
слух: слуху
информативный: информативный
оформить: оформил оформлены
презентация: презентацию
джумл: джумлу
подсветка: подсветка
допиливать: допиливать
отчёт: отчет отчеты
чистый: чистой
совесть: совестью
оптимизировать: оптимизируем
перебор: перебора
определеять: определеяем
вот: вот
нуждаться: нуждаются
выделяться: выделяется
ограниченный: ограниченный
оптимизация: оптимизации
потребовать: потребует
исправимый: исправим
навести: наведите навести
ничего: ничего
выполнимый: выполним
затрата: затраты
объектный: объектно
требование: требования требование
рассчитать: рассчитаны
выгодный: выгоднее
покупать: покупать покупаете
подобраться: подобрались
замечать: замечали замечают
аккаунт: аккаунтов
пора: пора
многоэкранный: многоэкранные
регистрироваться: регистрируется
забегать: забегая
конфигурация: конфигурации
надумать: надумаем
довершить: довершить
конструкция: конструкцию
грузить: грузят гружу
минутный: минутная
втянуться: втянемся
улечься: уляжется
мысленно: мысленно
усвоить: усвоить
послушать: послушать
докладчик: докладчик
инструмент: инструменты инструментах инструмент инструментов
мониторинг: мониторинга
сетевой: сетевых сетевые
потребление: потребления
доклад: доклад
слушать: слушая
отмахнуться: отмахнуться
признак: признаки
плохой: плохой плохая плохих
фича: фичи
отзыв: отзывов
маркет: маркете
баг: баги
уделять: уделять
скорость: скорости
эффективность: эффективности
вероятность: вероятностью
единоличный: единоличным
гуру: гуру
всерьёз: всерьез
интересоваться: интересуется
резюме: резюме
собеседование: собеседованиях собеседовании
пофиксиль: пофиксили
меморить: мемори
лик: ликов
ускорить: ускорили
тормоз: тормозов
скролл: скролле скролл скроллом
предпринимать: предпринимали
огромный: огромным
глаз: глазах
работодатель: работодателя
выявление: выявления
придерживаться: придерживаюсь
держать: держит
устранение: устранения
совет: советы
эффективный: эффективного
расходоваться: расходуется
освободить: освободить
утечка: утечка утечки
слабый: слабая
кастомизация: кастомизации
профайлер: профайлером
кадрв: кадрв
кадр: кадр
утилит: утилиту
детализировать: детализированный
насущный: насущные
достойный: достойная
толковый: толковые
вода: воды
трудно: трудно
затратить: затраченного
приятный: приятным
встречать: встречал
вакансия: вакансиях вакансия
много: много
отписаться: отписаться
подписка: подписки
переименовать: переименованы
парадигма: парадигме
корутина: корутины корутине корутину корутин корутина корутиной
приостанавливать: приостанавливает
блокировать: блокирован блокировать блокируя блокирует
отложить: отложенную
распараллеливать: распараллеливать
диспетчер: диспетчеров диспетчера
капот: капотом
интеграция: интеграцию
репозиторий: репозиторием
параллельный: параллельная
последовательно: последовательно
колбэковы: колбэков
сократить: сократить
ручной: ручное
умение: умения
покрывать: покрывать
сравнивать: сравнивает
совпасть: совпали
выявить: выявил
поломать: поломали
локальный: локальные локальный
мэтчеры: мэтчеры
кастомный: кастомный
мэтчер: мэтчер
таймаут: таймаута
посвятить: посвященный посвящен
обучение: обучению обучение
желательно: желательно
вписываться: вписываются
опытный: опытных опытные
трендовый: трендовые
опубликовать: опубликовано
делиться: делюсь
регулярный: регулярное
чтиво: чтиво
общение: общения
единомышленник: единомышленниками
хоть: хоть
й: й
удивляться: удивляться
азов: азов
упорядочивать: упорядочивать
выстроить: выстроит
принуждение: принуждение
подобрать: подобрать
внизу: внизу
открытка: открытка
клавиатура: клавиатуре
восстановить: восстановить
наворотить: наворотили
первоначальный: первоначальному
влево: влево
смещаться: смещалось
круг: круги круга
бок: бокам
зажать: зажмите
кружок: кружок
граница: границам границы границе границу граница границами
привязаться: привязался
необязательно: необязательно
вплотную: вплотную
отпустить: отпустите
величина: величина
уезжать: уезжал
привязываться: привязывается
привязывать: привязывать
ось: оси
перемещать: перемещать
выровняться: выровнялся
уравнять: уравняли
ровно: ровно
посередине: посередине
двусторонний: двусторонние двустороннюю
пружинка: пружинки
усложнить: усложним
перенастроить: перенастроив
пропорция: пропорции пропорцию
соблюдаться: соблюдаться
прислать: пришли
русски: русски
служба: службы служба
прояснить: прояснить
период: период
постоянный: постоянная
похоже: похоже
выполниться: выполнился
уничтожиться: уничтожился
тишина: тишина
жить: жить
удержание: удержанием
интервал: интервалом
секунда: секунду
замереть: замер
крутиться: крутится
start: starts start
android: android
language: language
front: front
end: end
framework: framework
twitter: twitter
inc: inc
code: code
licensed: licensed
font: font
preference: preference preferences
intent: intents intent
activity: activity activities
ini: ini
sqlite: sqlite
sd: sd
extra: extras
save: save saves
load: load
project: project projects
name: name names
build: build
target: target
application: application applications
sharedpreferences: sharedpreferences
package: package packages
ru: ru
startandroid: startandroid
develop: develop
create: create
mainactivity: mainactivity
main: main
xml: xml
version: version versions
encoding: encoding
utf: utf
linearlayout: linearlayout
xmlns: xmlns
http: http https
schema: schemas schema
com: com
apk: apk
re: res
orientation: orientation
vertical: vertical
edittext: edittext
id: ids id
ettext: ettext
requestfocus: requestfocus
horizontal: horizontals horizontal
button: button buttons
btnsave: btnsave
text: text texts
btnload: btnload
java: java
import: imports import
app: app
content: content contents
editor: editor
o: os
bundle: bundle
view: views view
onclicklistener: onclicklistener
widget: widget
toast: toast
public: public
class: classes class
extends: extends
implement: implements implement
spref: spref
final: final
string: strings string
called: called
first: first
created: created
override: override
void: void
oncreate: oncreate
savedinstancestate: savedinstancestate
super: super
setcontentview: setcontentview
r: r
layout: layouts layout
findviewbyid: findviewbyid
setonclicklistener: setonclicklistener
onclick: onclick
v: v
switch: switches switch
getid: getid
case: case cases
savetext: savetext
break: break
loadtext: loadtext
default: default
getpreferences: getpreferences
ed: ed
edit: edit
putstring: putstring
gettext: gettext
tostring: tostring
commit: commit
maketext: maketext
saved: saved
show: shows show
savedtext: savedtext
getstring: getstring
settext: settext
loaded: loaded
ondestroy: ondestroy
protected: protected
eclipse: eclipse
window: windows window
file: file files
explorer: explorer
data: data
map: map maps
abcdefg: abcdefg
getsharedpreferences: getsharedpreferences
mypref: mypref
int: int
mode: mode modes
return: return returns
getlocalclassname: getlocalclassname
telegram: telegram
medium: medium
lesson: lessons lesson
storing: storing
enough: enough
speaking: speaking
let: lets let
speak: speak
several: several
way: way ways
store: store stores
like: like
database: databases database
table: table tables
common: common
internal: internal
external: external
card: card
begin: begins begin
simplest: simplest
value: value values
used: used
pair: pair pairs
well: well
within: within
field: field fields
clicking: clicking
new: new
open: open opens
two: two
determining: determining
listener: listener listeners
setting: setting settings
implementation: implementations implementation
interested: interested
method: method methods
call: call calls
get: get gets
object: objects object
allows: allows
u: us
work: works work
read: read reads
right: rights right
constant: constant constants
access: accesses access
adjustment: adjustment
mean: means
would: would
accessible: accessible
saving: saving
need: need needs
editing: editing
pas: pass
key: key
must: must
loading: loading
similarly: similarly
although: although
use: use
parameter: parameters parameter
empty: empty
set: sets set
display: display displays
message: messages message
launch: launch launches
make: makes make
sure: sure
type: type types
anything: anything
close: closes close
without: without
find: finds find
emulator: emulators emulator
list: list lists
entered: entered
lost: lost
closing: closing
also: also
useful: useful
try: try
something: something
enter: enter
click: click clicks
automatically: automatically
opening: opening
add: add adds
entering: entering
lose: lose
decide: decide
thing: things thing
know: know knows
take: takes take
look: look looks
chose: chose
displayed: displayed
see: see
next: next
copy: copy
pc: pc
source: sources source
current: current
passed: passed
eventually: eventually
want: wants want
come: come comes
getsharedpreference: getsharedpreference
choose: choose
unix: unix
rwx: rwx
instead: instead
change: changes change
full: full
lifecycle: lifecycle
example: examples example
changing: changing
state: state states
learn: learn
translated: translated
tara: taras
leskiv: leskiv
previous: previous
looked: looked
invoked: invoked
lifetime: lifetime
seen: seen
resumed: resumed
visible: visible
focused: focused
using: using
understand: understand
remain: remain
stopped: stopped
exists: exists
memory: memory
twoactivitystate: twoactivitystate
write: write
following: following
textview: textview
hello: hello
world: world
go: go goes
btnacttwo: btnacttwo
including: including
onrestart: onrestart
time: times time
log: logs log
entry: entry entries
inside: inside
define: define
assign: assign
util: util
tag: tag
onstart: onstart
onresume: onresume
onpause: onpause
onstop: onstop
order: order
working: working
one: one ones
behaviour: behaviour
second: seconds second
activitytwo: activitytwo
remember: remember
subclass: subclass
register: register
manifest: manifest
fill: fill fills
clear: clears clear
forget: forget
record: record records
invoking: invoking
startactivity: startactivity
highlighted: highlighted
filter: filters filter
everything: everything
run: run runs
step: step steps
appeared: appeared
three: three
paused: paused
remains: remains
press: press
appear: appear
mainactivty: mainactivty
invocation: invocations invocation
loses: loses
focus: focus
pause: pause
receives: receives
note: notes note
destroyed: destroyed
interact: interact
back: back
returned: returned
restored: restored
written: written
scratch: scratch
exactly: exactly
killed: killed
system: system
still: still
went: went
gained: gained
changed: changed
closed: closed
fis: fis
repeat: repeat
algorithm: algorithm algorithms
check: checks check
diagram: diagram diagrams
quite: quite
obvious: obvious
help: helps help
draw: draw
whole: whole
sheet: sheet
paper: paper
sequence: sequence
found: found
necessarily: necessarily
stored: stored
ram: ram
looking: looking
guess: guess
question: question questions
disappeared: disappeared
screen: screen screens
left: left
exceptional: exceptional
talk: talk
already: already
complicated: complicated
topic: topics topic
extremely: extremely
important: important
concept: concept concepts
operating: operating
theory: theory
task: task tasks
fixing: fixing
dagger: dagger
dependency: dependency dependencies
injection: injection
lazy: lazy
provider: provider
named: named
qualifier: qualifier
intoset: intoset
elementsintoset: elementsintoset
intomap: intomap
inject: inject
subcomponent: subcomponent
scope: scope
produced: produced
productioncomponent: productioncomponent
producermodule: producermodule
produce: produce produces
producer: producer
builder: builder
bindsinstance: bindsinstance
mvp: mvp
subcomponents: subcomponents
module: modules module
androidinjection: androidinjection
fragment: fragment fragments
daggeractivity: daggeractivity
daggerfragment: daggerfragment
behavior: behavior
creation: creation
running: running
old: old
hide: hide hides
process: process
event: events event
required: required
free: free frees
resource: resources resource
described: described
detail: detail details
user: users user
sometimes: sometimes
runningpaused: runningpaused
cannot: cannot
covered: covered
another: another
cover: cover covers
transparent: transparent
completely: completely
invokes: invokes
different: different
illustrated: illustrated
simplify: simplify
understanding: understanding
given: given
brief: brief
description: description
bracket: brackets
cross: cross
exist: exist
timeonstart: timeonstart
shown: shown
useronresume: useronresume
becomes: becomes
available: available
interaction: interaction
shownonstop: shownonstop
userondestroy: userondestroy
cause: cause
vice: vice
versa: versa
trigger: triggers trigger
informed: informed
react: react
accordingly: accordingly
practice: practice
emulate: emulate
wrong: wrong
avd: avd
oneactivitystatepackage: oneactivitystatepackage
usual: usual
familiar: familiar
implemented: implemented
business: business
creates: creates
give: give gives
opportunity: opportunity
participate: participate
tell: tells tell
remaining: remaining
implementing: implementing
always: always
invoke: invoke
corresponding: corresponding
superclass: superclass
contains: contains
located: located
configure: configure
pile: pile
learnt: learnt
done: done
third: third
ability: ability abilities
opposite: opposite
disappears: disappears
behave: behave
ctrl: ctrl
nothing: nothing
special: special
happened: happened
procedure: procedure procedures
restoring: restoring
usually: usually
occur: occur
appearance: appearance
book: books book
presented: presented
little: little
bit: bit
template: template
explanation: explanations explanation
seems: seems
hope: hope
managed: managed
explain: explain
subject: subject
advice: advice
documentation: documentation
link: links link
provided: provided
beginning: beginning
better: better
moment: moment
later: later
action: actions action
uri: uri
webview: webview
simplebrowser: simplebrowser
btnweb: btnweb
web: web
net: net
parse: parse
www: www
ya: ya
browser: browser
browseractivity: browseractivity
webkit: webkit
setwebviewclient: setwebviewclient
webviewclient: webviewclient
getintent: getintent
getdata: getdata
loadurl: loadurl
scheme: scheme
category: category
label: label
mybrowser: mybrowser
us: uses
permission: permission permissions
internet: internet
c: c
html: html
versioncode: versioncode
versionname: versionname
sdk: sdk
minsdkversion: minsdkversion
icon: icon
drawable: drawable
launcher: launcher
layoutinflater: layoutinflater
inflate: inflate
mainroot: mainroot
viewgroup: viewgroup
layoutparams: layoutparams
attachtoroot: attachtoroot
root: root
true: true
addview: addview
false: false
linlayout: linlayout
linear: linear
relativelayout: relativelayout
rellayout: rellayout
relative: relative
tvlayout: tvlayout
mylogs: mylogs
ltinflater: ltinflater
getlayoutinflater: getlayoutinflater
null: null
lp: lp
getlayoutparams: getlayoutparams
getclass: getclass
textviewlayoutparams: textviewlayoutparams
truetext: truetext
textviewclass: textviewclass
layoutparamstext: layoutparamstext
menu: menu menus
group: group groups
menuinflater: menuinflater
item: item items
sort: sort
observed: observed
creating: creating
groupid: groupid
identifier: identifier
belongs: belongs
toitemid: toitemid
idorder: idorder
specifying: specifying
showntitle: showntitle
illustrate: illustrate
checkbox: checkbox
chosen: chosen
whether: whether
simple: simple
expanded: expanded
clarify: clarify
term: term terms
naming: namings
menuadvpackage: menuadvpackage
menuadvcreate: menuadvcreate
existing: existing
erase: erase
chbextmenu: chbextmenu
element: elements element
tv: tv
chb: chb
boolean: boolean
oncreateoptionsmenu: oncreateoptionsmenu
todo: todo
auto: auto
generated: generated
stub: stub
adding: adding
delete: delete
paste: paste
exit: exit
update: update updates
onprepareoptionsmenu: onprepareoptionsmenu
checked: checked
setgroupvisible: setgroupvisible
ischecked: ischecked
onoptionsitemselected: onoptionsitemselected
menuitem: menuitem
stringbuilder: stringbuilder
sb: sb
print: print
info: info
pressed: pressed
append: append
n: n
valueof: valueof
getgroupid: getgroupid
itemid: itemid
getitemid: getitemid
getorder: getorder
title: title
gettitle: gettitle
shift: shift
every: every
displaying: displaying
necessary: necessary
clicked: clicked
equal: equals equal
united: united
visually: visually
differ: differ
color: color colors
else: else
defines: defines
position: position positions
defining: defining
ascending: ascending
smaller: smaller
larger: larger
fourth: fourth
depending: depending
pay: pay
attention: attention
sorted: sorted
positioned: positioned
pressing: pressing
triggered: triggered
output: output
information: information
compare: compare
coded: coded
match: match matches
made: made
convenience: convenience
hardcoded: hardcoded
number: numbers number
recommended: recommended
convenient: convenient
preferable: preferable
programmatically: programmatically
mymenu: mymenu
folder: folder folders
orderincategory: orderincategory
attribute: attribute attributes
approach: approach
component: components component
generate: generate
hardcode: hardcode
connect: connect
getmenuinflater: getmenuinflater
obtain: obtain
recommend: recommend
test: tests test
flexible: flexible
shrink: shrinks
amount: amount
context: context
proguard: proguard
itemcontroller: itemcontroller
datacontroller: datacontroller
apiservice: apiservice
restadapter: restadapter
okhttpclient: okhttpclient
cache: cache
mainactivitypresenter: mainactivitypresenter
activitypresenter: activitypresenter
cachedirectory: cachedirectory
path: path
httpresponsecache: httpresponsecache
httpclient: httpclient
setcache: setcache
setclient: setclient
okclient: okclient
getcomponent: getcomponent
getpresenter: getpresenter
createinstance: createinstance
presenter: presenter
itemmodule: itemmodule
networkmodule: networkmodule
storagemodule: storagemodule
mcdonalds: mcdonalds
gradle: gradle
compile: compile
google: google
annotationprocessor: annotationprocessor
compiler: compiler
plugin: plugin
bitbucket: bitbucket
org: org
hvisser: hvisser
apt: apt
buildscript: buildscript
repository: repositories
mavencentral: mavencentral
classpath: classpath
neenbedankt: neenbedankt
plugins: plugins
apply: apply
databasehelper: databasehelper
networkutils: networkutils
provides: provides
providenetworkutils: providenetworkutils
providedatabasehelper: providedatabasehelper
interface: interfaces interface
appcomponent: appcomponent
daggerappcomponent: daggerappcomponent
getnetworkutils: getnetworkutils
getdatabasehelper: getdatabasehelper
private: private
static: static
studio: studio
npe: npe
injectsmainactivity: injectsmainactivity
mainactivitymembersinjector: mainactivitymembersinjector
injectmembers: injectmembers
instance: instance
throw: throws throw
nullpointerexception: nullpointerexception
member: member members
reference: reference
databasehelperprovider: databasehelperprovider
networkutilsprovider: networkutilsprovider
providehttpclient: providehttpclient
runtime: runtime
error: error errors
constructor: constructor
annotated: annotated
stackoverflow: stackoverflow
move: move
toward: toward
jack: jack
sync: sync
rx: rx
cheap: cheap
hosting: hosting
year: year
ixram: ixram
image: images image
photo: photos
jpg: jpg
autowired: autowired
daggergetbreakfast: daggergetbreakfast
formed: formed
placed: placed
taken: taken
explained: explained
good: good
interpretation: interpretation
contain: contain
send: send
mail: mail
sent: sent
single: single
workflow: workflow
achieved: achieved
explaining: explaining
analogy: analogies analogy
similar: similar
mechanism: mechanisms mechanism
organization: organization
navigation: navigation
currently: currently
tab: tabs tab
opened: opened
page: page pages
forward: forward
absent: absent
removed: removed
background: background
active: active
foreground: foreground
finally: finally
androidtab: androidtab
history: history
visited: visited
taskpage: taskpage
activitylink: activitylink
easier: easier
performs: performs
specific: specific
operation: operations operation
starting: starting
home: home
shortcut: shortcut
marked: marked
put: put puts
notice: notices notice
corresponds: corresponds
bring: bring
top: top
deleted: deleted
gain: gains
added: added
ordered: ordered
stack: stack
official: official
site: site sites
demonstrates: demonstrates
part: part parts
bottom: bottom
suppose: suppose
able: able
launching: launching
whose: whose
hold: holds hold
lot: lots lot
nuance: nuance nuances
complication: complications
stop: stop
knowledge: knowledge
answer: answer
saw: saw
gone: gone
wanted: wanted
catch: catch
even: even
partially: partially
achieve: achieve
dialog: dialog
style: style
behind: behind
androidmanifest: androidmanifest
theme: theme
correct: correct
needed: needed
clearly: clearly
noticed: noticed
difference: differences difference
happen: happen
reading: reading
normal: normal
line: line lines
multiple: multiple
play: play
around: around
solid: solid
implicit: implicit
developer: developers developer
getscheme: getscheme
httpuri: httpuri
getschemespecificpart: getschemespecificpart
htmluri: htmluri
getauthority: getauthority
comuri: comuri
gethost: gethost
getpath: getpath
getlastpathsegment: getlastpathsegment
authority: authority
host: host
rfc: rfc
ftp: ftp
bob: bob
ftpuri: ftpuri
filesuri: filesuri
getport: getport
getuserinfo: getuserinfo
geo: geo
geouri: geouri
schemespecificpart: schemespecificpart
tel: tel
teluri: teluri
contact: contact contacts
people: people
contenturi: contenturi
contactsuri: contactsuri
manager: manager
apis: apis
api: api
level: levels level
simpleintents: simpleintents
btnmap: btnmap
btncall: btncall
setaction: setaction
setdata: setdata
b: b
unable: unable
url: url
last: last
overloaded: overloaded
understood: understood
problem: problems problem
basis: basis
material: materials
confirm: confirm
become: become
explicitly: explicitly
aware: aware
based: based
point: point points
functionality: functionality
complete: complete
solve: solve
date: date
intentfilterpackage: intentfilterpackage
btntime: btntime
btndate: btndate
showtime: showtime
showdate: showdate
defined: defined
specify: specify
specifies: specifies
perform: perform
selection: selection
performed: performed
specified: specified
address: address
coordinate: coordinate coordinates
phone: phone
etc: etc
enumerated: enumerated
came: came
showtimeru: showtimeru
could: could
represents: represents
accomplish: accomplish
understandable: understandable
prefix: prefix
avoid: avoid
collision: collisions
may: may
installed: installed
intercept: intercept
fit: fits fit
activitytime: activitytime
registered: registered
place: place places
select: select
ok: ok
analogically: analogically
tvtime: tvtime
textsize: textsize
sql: sql
simpledateformat: simpledateformat
sdf: sdf
hh: hh
mm: mm
s: ss
format: format
currenttimemillis: currenttimemillis
calculate: calculate
activitydate: activitydate
tvdate: tvdate
dd: dd
yyyy: yyyy
wrote: wrote
appropriate: appropriate
choice: choice
slightly: slightly
activitydateex: activitydateex
actually: actually
absolutely: absolutely
identical: identical
eee: eee
mmm: mmm
showed: showed
parent: parent parents
distinguish: distinguish
fix: fix
providing: providing
proper: proper
basic: basic basics
activitydatedate: activitydatedate
extended: extended
significantly: significantly
gave: gave
great: great
got: got
structure: structure
activityonstart: activityonstart
activityonstop: activityonstop
stoped: stoped
captcha: captcha
onclickbuttonspackage: onclickbuttonspackage
onclickbuttonscreate: onclickbuttonscreate
tvout: tvout
btnok: btnok
btncancel: btncancel
cancel: cancel
declare: declare
variable: variable variables
outside: outside
enable: enable
referencing: referencing
initialize: initialize
resulted: resulted
section: section
correspond: correspond
teach: teach
delegate: delegate
processing: processing
continue: continue
writing: writing
oclbtnok: oclbtnok
underline: underlines
red: red
yet: yet
offer: offers offer
requires: requires
decided: decided
ready: ready
resulting: resulting
assigned: assigned
oclbtncancel: oclbtncancel
result: results result
reacts: reacts
follow: follow
act: act
menusimplepackage: menusimplepackage
menusimplecreate: menusimplecreate
responsible: responsible
checking: checking
condition: condition conditions
returning: returning
four: four
possible: possible
best: best
differently: differently
intentextras: intentextras
gravity: gravity
input: input
tablelayout: tablelayout
stretchcolumns: stretchcolumns
tablerow: tablerow
etfname: etfname
etlname: etlname
btnsubmit: btnsubmit
submit: submit
viewactivity: viewactivity
putextra: putextra
fname: fname
lname: lname
tvview: tvview
getstringextra: getstringextra
john: john
smith: smith
onupgrade: onupgrade
sqliteopenhelper: sqliteopenhelper
dbhelper: dbhelper
sqliteonupgradedbpackage: sqliteonupgradedbpackage
contentvalues: contentvalues
cursor: cursor
sqlitedatabase: sqlitedatabase
staff: staff
dbh: dbh
db: db
getwritabledatabase: getwritabledatabase
getversion: getversion
writestaff: writestaff
rawquery: rawquery
logcursor: logcursor
movetofirst: movetofirst
getcount: getcount
row: row rows
setlength: setlength
cn: cn
getcolumnnames: getcolumnnames
getcolumnindex: getcolumnindex
movetonext: movetonext
cv: cv
execsql: execsql
integer: integer
primary: primary
autoincrement: autoincrement
length: length
insert: insert
oldversion: oldversion
newversion: newversion
posid: posid
sqlquery: sqlquery
pl: pl
p: ps p
salary: salary
inner: inner
join: join
begintransaction: begintransaction
alter: alter
column: columns column
temporary: temporary
drop: drop
settransactionsuccessful: settransactionsuccessful
endtransaction: endtransaction
listview: listview
simplelistpackage: simplelistpackage
composite: composite
lvmain: lvmain
arrayadapter: arrayadapter
adapter: adapters adapter
setadapter: setadapter
textviewnames: textviewnames
jar: jar
textappearance: textappearance
attr: attr
textappearancelarge: textappearancelarge
paddingleft: paddingleft
minheight: minheight
listpreferreditemheight: listpreferreditemheight
padding: padding
textcolor: textcolor
arrаyadapter: arrаyadapter
directory: directory
actionbar: actionbar
introduction: introduction
afternoon: afternoon
introductory: introductory
enlighten: enlighten
reason: reason reasons
started: started
development: development
half: half
stage: stage
acquaintance: acquaintance
ended: ended
unfortunately: unfortunately
think: think
across: across
article: article articles
five: five
much: much
seem: seem
vague: vague
unclear: unclear
beginner: beginners
unknown: unknown
reader: reader
detailed: detailed
clearness: clearness
include: include
consolidation: consolidation
independent: independent
isolated: isolated
browse: browse
unnecessary: unnecessary
stuff: stuff
trying: trying
pick: pick
unlike: unlike
author: authors
going: going
programming: programming
hour: hours hour
realize: realize
many: many
mind: mind
hundred: hundred
advanced: advanced
learning: learning
likely: likely
visit: visit
except: except
additional: additional
consistent: consistent
manual: manual
neglect: neglect
ignore: ignore
superfluous: superfluous
please: please
consider: consider
improve: improve
demand: demand
market: market
channel: channel
interesting: interesting
install: install
environment: environment
require: require
related: related
technology: technologies
assumed: assumed
periodically: periodically
release: releases release
deprecated: deprecated
real: real
picture: picture pictures
screenshots: screenshots
substantial: substantial
startofandroid: startofandroid
gmail: gmail
size: size sizes
obviously: obviously
critical: critical
influence: influence
premise: premise
refer: refer
property: property properties
viewbyid: viewbyid
either: either
comfortable: comfortable
strict: strict
mytext: mytext
tethered: tethered
remind: remind
mytextview: mytextview
underlined: underlined
cast: cast
mybtn: mybtn
leave: leave
interfere: interfere
logical: logical
disabled: disabled
setenabled: setenabled
enabled: enabled
mychb: mychb
tick: tick ticks
setchecked: setchecked
refers: refers
provide: provide
discus: discuss
notion: notions
couple: couple
decrease: decrease
inter: inter
developing: developing
hand: hands hand
library: libraries library
pattern: pattern
mini: mini
training: training
course: courses course
describe: describe
simply: simply
advantage: advantages
opposed: opposed
follows: follows
easy: easy
debug: debug
compilation: compilation
issue: issues issue
away: away
challenging: challenging
expected: expected
strongly: strongly
circumstance: circumstances
experience: experience
life: life
helped: helped
might: might
small: small
abstract: abstract
model: model
situation: situations situation
entail: entails
say: say
certain: certain
according: according
however: however
cashe: cashe
standard: standard
really: really
care: care
desired: desired
outcome: outcome
anywhere: anywhere
moved: moved
individual: individual
ahead: ahead
entire: entire
hierarchy: hierarchy
moving: moving
duplicate: duplicate
everywhere: everywhere
purpose: purpose purposes
regular: regular
normally: normally
comprises: comprises
associated: associated
includes: includes
consists: consists
agent: agent
request: requests request
lunch: lunch
mcdonald: mcdonald
customer: customer
cashier: cashier
production: production
big: big
mac: mac
fry: fries
coke: coke
together: together
pours: pours
glass: glass
onto: onto
tray: tray
bag: bag
receive: receive
download: download
blank: blank
precisely: precisely
annotation: annotation annotations
indicates: indicates
supply: supply
technical: technical
standpoint: standpoint
pretty: pretty
manage: manage
intended: intended
describes: describes
compiled: compiled
involves: involves
option: options option
complement: complement
search: search
various: various
respective: respective
finished: finished
somewhere: somewhere
upset: upset
happens: happens
offering: offering
crashing: crashing
luckily: luckily
solution: solution
rewrite: rewrite
indicate: indicate
telling: telling
expect: expect
determine: determine
mark: mark
assignment: assignment
saying: saying
separately: separately
clarity: clarity
total: total
referred: referred
graph: graph
talked: talked
dozen: dozen
chain: chain
easily: easily
future: future
kind: kind
building: building
rather: rather
logically: logically
complains: complains
touched: touched
upon: upon
difficulty: difficulties
general: general
principle: principle
role: role
feature: features
offered: offered
organized: organized
explore: explore
separate: separate
thread: thread
androidвкладка: androidвкладка
taskстраница: taskстраница
activityссылка: activityссылка
packagecontext: packagecontext
cl: cls
activiy: activiy
remove: removes remove
androidruntime: androidruntime
activitynotfoundexception: activitynotfoundexception
explicit: explicit
declared: declared
logcat: logcat
apps: apps
dialer: dialer
viewing: viewing
often: often
applied: applied
smth: smth
disassembles: disassembles
allowed: allowed
document: document
allow: allow
retrieve: retrieve
parsed: parsed
colon: colon
others: others
linked: linked
meaning: meanings meaning
verify: verify
space: spaces space
program: program programs
unveil: unveil
inquire: inquire
supported: supported
uris: uris
identified: identified
adjusted: adjusted
wait: wait
downloaded: downloaded
platform: platforms platform
followed: followed
word: words word
determined: determined
dial: dial
lead: lead
connection: connection
launched: launched
showing: showing
dialed: dialed
suggest: suggest
experiment: experiments experiment
warn: warn
suitable: suitable
range: range
e: e
incorrect: incorrect
wright: wright
turn: turn turns
waiting: waiting
agree: agree
designed: designed
oncilck: oncilck
logandmess: logandmess
verbose: verbose
w: w
pid: pid
perspective: perspective
ddms: ddms
device: devices device
duration: duration
location: location locations
weight: weight
seekbar: seekbar
occupied: occupied
max: max
progress: progress
sbweight: sbweight
scrollbar: scrollbar
scrolled: scrolled
maximum: maximum
bar: bar
width: width widths
share: share
stretched: stretched
equally: equally
casting: casting
onseekbarchangelistener: onseekbarchangelistener
declaration: declaration
onprogresschanged: onprogresschanged
fromuser: fromuser
onstarttrackingtouch: onstarttrackingtouch
onstoptrackingtouch: onstoptrackingtouch
dragging: dragging
dragged: dragged
leftvalue: leftvalue
rightvalue: rightvalue
getmax: getmax
minus: minus
correspondingly: correspondingly
bigger: bigger
greater: greater
setonseekbarchangelistener: setonseekbarchangelistener
tellingly: tellingly
requestlayout: requestlayout
redraw: redraw
sensible: sensible
calculator: calculator
actionbaritems: actionbaritems
showasaction: showasaction
ifroom: ifroom
withtext: withtext
never: never
overflow: overflow
getactionbar: getactionbar
noactionbar: noactionbar
logo: logo
getintentaction: getintentaction
tvinfo: tvinfo
getaction: getaction
textinfo: textinfo
datetime: datetime
intentfilter: intentfilter
opengl: opengl
surface: surface
glsl: glsl
raw: raw
float: float
x: x
z: z
precision: precision
mediump: mediump
uniform: uniform
lowp: lowp
highp: highp
rgba: rgba
fileutils: fileutils
io: io
bufferedreader: bufferedreader
ioexception: ioexception
inputstream: inputstream
inputstreamreader: inputstreamreader
readtextfromraw: readtextfromraw
resourceid: resourceid
getresources: getresources
openrawresource: openrawresource
readline: readline
ioex: ioex
printstacktrace: printstacktrace
notfoundexception: notfoundexception
nfex: nfex
shaderutils: shaderutils
glattachshader: glattachshader
glcompileshader: glcompileshader
glcreateprogram: glcreateprogram
glcreateshader: glcreateshader
gldeleteprogram: gldeleteprogram
gldeleteshader: gldeleteshader
glgetprogramiv: glgetprogramiv
glgetshaderiv: glgetshaderiv
gllinkprogram: gllinkprogram
glshadersource: glshadersource
createprogram: createprogram
vertexshaderid: vertexshaderid
fragmentshaderid: fragmentshaderid
programid: programid
linkstatus: linkstatus
createshader: createshader
shaderrawid: shaderrawid
shadertext: shadertext
shaderid: shaderid
compilestatus: compilestatus
vertexshaderrawid: vertexshaderrawid
fragmentshaderrawid: fragmentshaderrawid
openglrenderer: openglrenderer
glsurfaceview: glsurfaceview
renderer: renderer
nio: nio
bytebuffer: bytebuffer
byteorder: byteorder
floatbuffer: floatbuffer
javax: javax
microedition: microedition
khronos: khronos
egl: egl
eglconfig: eglconfig
opengles: opengles
glclear: glclear
glclearcolor: glclearcolor
gldrawarrays: gldrawarrays
glenablevertexattribarray: glenablevertexattribarray
glgetattriblocation: glgetattriblocation
glgetuniformlocation: glgetuniformlocation
gluseprogram: gluseprogram
glvertexattribpointer: glvertexattribpointer
glviewport: glviewport
vertexdata: vertexdata
ucolorlocation: ucolorlocation
apositionlocation: apositionlocation
preparedata: preparedata
onsurfacecreated: onsurfacecreated
binddata: binddata
onsurfacechanged: onsurfacechanged
height: height
vertex: vertices
allocatedirect: allocatedirect
nativeorder: nativeorder
asfloatbuffer: asfloatbuffer
ondrawframe: ondrawframe
indx: indx
normalized: normalized
stride: stride
buffer: buffer
ptr: ptr
count: count
setrenderer: setrenderer
startactivityforresult: startactivityforresult
sm: sms
simpleactivityresult: simpleactivityresult
btnname: btnname
tvname: tvname
nameactivity: nameactivity
onactivityresult: onactivityresult
requestcode: requestcode
resultcode: resultcode
acivity: acivity
etname: etname
setresult: setresult
finish: finish
fragmenttransaction: fragmenttransaction
tablistener: tablistener
setnavigationmode: setnavigationmode
newtab: newtab
settablistener: settablistener
addtab: addtab
ontabreselected: ontabreselected
ft: ft
reselected: reselected
ontabselected: ontabselected
selected: selected
ontabunselected: ontabunselected
unselected: unselected
backstack: backstack
onnavigationlistener: onnavigationlistener
setdropdownviewresource: setdropdownviewresource
setlistnavigationcallbacks: setlistnavigationcallbacks
onnavigationitemselected: onnavigationitemselected
itemposition: itemposition
long: long
spinneradapter: spinneradapter
holo: holo
light: light
uioptions: uioptions
splitactionbarwhennarrow: splitactionbarwhennarrow
listfragment: listfragment
examine: examine
margin: margins margin
physical: physical
resolution: resolutions resolution
distance: distance
corner: corners corner
measured: measured
inch: inch inches
horizontally: horizontally
vertically: vertically
pixel: pixel pixels
htc: htc
desire: desire
smartphone: smartphone
dpi: dpi
dot: dots dot
per: per
remembering: remembering
diagonal: diagonal
side: sides side
absolute: absolute
possibility: possibilities
mu: mu
dp: dp
dip: dip
density: density
unit: units unit
measure: measure
alike: alike
sp: sp
scale: scale
pt: pt
px: px
millimeter: millimeter
occupy: occupy
layoutprop: layoutprop
became: became
wider: wider
stretch: stretches stretch
independently: independently
occupies: occupies
distributed: distributed
proportionally: proportionally
neighbour: neighbour
dividing: dividing
quarter: quarter quarters
claim: claim
ignored: ignored
ratio: ratios
alignment: alignment
excel: excel
demonstrate: demonstrate
framelayout: framelayout
lined: lined
demonstrating: demonstrating
grlayout: grlayout
center: center
honestly: honestly
tried: tried
regarding: regarding
comment: comments comment
marginlayout: marginlayout
middle: middle
appears: appears
dptop: dptop
dpmargin: dpmargin
dpright: dpright
valuable: valuable
design: design
modelling: modelling
making: making
coding: coding
deletion: deletion
radiogroup: radiogroup
rggravity: rggravity
radiobutton: radiobutton
rbleft: rbleft
rbcenter: rbcenter
rbright: rbright
fadescrollbars: fadescrollbars
btncreate: btncreate
btnclear: btnclear
llmain: llmain
radiobuttons: radiobuttons
deletes: deletes
createdllmain: createdllmain
finding: finding
wrapcontent: wrapcontent
le: less
filling: filling
lparams: lparams
btngravity: btngravity
bntgravity: bntgravity
getcheckedradiobuttonid: getcheckedradiobuttonid
received: received
btnnew: btnnew
mentioned: mentioned
otherwise: otherwise
assing: assing
sufficient: sufficient
keyboard: keyboard
block: blocks
disappear: disappear
esc: esc
japanese: japanese
hieroglyph: hieroglyphs
mouse: mouse
unimplemented: unimplemented
statement: statement
removeallviews: removeallviews
child: child
success: success
dynamic: dynamic
resvaluespackage: resvaluespackage
resvaluescreate: resvaluescreate
lltop: lltop
tvtop: tvtop
btntop: btntop
llbottom: llbottom
tvbottom: tvbottom
btnbottom: btnbottom
myres: myres
tvtoptext: tvtoptext
btntoptext: btntoptext
tvbottomtext: tvbottomtext
btnbottomtext: btnbottomtext
lltopcolor: lltopcolor
llbottomcolor: llbottomcolor
setbackgroundresource: setbackgroundresource
illustrates: illustrates
bound: bound bounds
illustrating: illustrating
news: news
notifies: notifies
capable: capable
okay: okay
dependning: dependning
mistake: mistake
recognized: recognized
figured: figured
developed: developed
passing: passing
activityresult: activityresult
tvtext: tvtext
btncolor: btncolor
btnalign: btnalign
btnred: btnred
btngreen: btngreen
green: green
btnblue: btnblue
blue: blue
coloractivity: coloractivity
graphic: graphics
align: align
btnleft: btnleft
btncenter: btncenter
btnright: btnright
alignactivity: alignactivity
getintextra: getintextra
white: white
settextcolor: settextcolor
setgravity: setgravity
usage: usage
fluently: fluently
took: took
differentiation: differentiation
successful: successful
choosing: choosing
identify: identify
status: status
alline: alline
though: though
ease: ease
calling: calling
mainactiivty: mainactiivty
logging: logging
visual: visual
argument: argument arguments
completion: completion
extract: extract
response: response
push: push
failed: failed
constraint: constraint constraints
sum: sum
query: query
processed: processed
enables: enables
therefore: therefore
simplifies: simplifies
effort: effort
sound: sounds
tempting: tempting
fact: fact
difficult: difficult
outlined: outlined
exploring: exploring
moreover: moreover
wasted: wasted
realized: realized
broke: broke
collected: collected
supplied: supplied
spend: spend
broken: broken
registration: registration
payment: payment
cost: cost
asynchronous: asynchronous
fragmentactivity: fragmentactivity
oncreateview: oncreateview
inflater: inflater
container: container
tool: tools
btnfind: btnfind
getfragmentmanager: getfragmentmanager
fragmentmanager: fragmentmanager
findfragmentbyid: findfragmentbyid
getview: getview
getactivity: getactivity
onsomeeventlistener: onsomeeventlistener
someevent: someevent
someeventlistener: someeventlistener
onattach: onattach
classcastexception: classcastexception
study: study
recall: recall
array: array
iteration: iteration
filled: filled
variant: variant
far: far
believe: believe
expand: expand
scroll: scroll
double: double
asks: asks
convert: converts convert
colored: colored
undergo: undergo
conversion: conversion
told: told
confirmation: confirmation
getting: getting
function: functions
unavailable: unavailable
xmlpullparser: xmlpullparser
company: company
samsung: samsung
galaxy: galaxy
price: price
multitouch: multitouch
yes: yes
black: black
xmlpull: xmlpull
xmlpullparserexception: xmlpullparserexception
textutils: textutils
tmp: tmp
xpp: xpp
preparexpp: preparexpp
geteventtype: geteventtype
getname: getname
depth: depth
getdepth: getdepth
attrcount: attrcount
getattributecount: getattributecount
getattributename: getattributename
getattributevalue: getattributevalue
isempty: isempty
getxml: getxml
xmlpullparserfactory: xmlpullparserfactory
factory: factory
newinstance: newinstance
namespace: namespace
setnamespaceaware: setnamespaceaware
newpullparser: newpullparser
setinput: setinput
stringreader: stringreader
instant: instant
challenge: challenge
senior: senior
rxjava: rxjava
telegramm: telegramm
retrofit: retrofit
constraintlayout: constraintlayout
circular: circular
notifydatasetchanged: notifydatasetchanged
recyclerview: recyclerview
droidcon: droidcon
berlin: berlin
support: support
appcompat: appcompat
cardview: cardview
execution: execution
accepts: accepts
determines: determines
viewgroups: viewgroups
relevant: relevant
binding: binding
converted: converted
alright: alright
command: command
stay: stays
bind: bind
differs: differs
refactor: refactor
soon: soon
overlapped: overlapped
adjust: adjust
essential: essential
linearlayoutclass: linearlayoutclass
layoutparamsclass: layoutparamsclass
relativelayoutclass: relativelayoutclass
respectively: respectively
kotlin: kotlin
console: console
dynamicactionbar: dynamicactionbar
sethasoptionsmenu: sethasoptionsmenu
chbadddel: chbadddel
chbvisible: chbvisible
btnfrag: btnfrag
cont: cont
groupvsbl: groupvsbl
frag: frag
seticon: seticon
setshowasaction: setshowasaction
removeitem: removeitem
invalidateoptionsmenu: invalidateoptionsmenu
replace: replace
onсlick: onсlick
actionmode: actionmode
simplelistchoicepackage: simplelistchoicepackage
btnchecked: btnchecked
simplelistchoice: simplelistchoice
setchoicemode: setchoicemode
charsequence: charsequence
createfromresource: createfromresource
getstringarray: getstringarray
getcheckeditemposition: getcheckeditemposition
sparsebooleanarray: sparsebooleanarray
sbarray: sbarray
getcheckeditempositions: getcheckeditempositions
keyat: keyat
choicemode: choicemode
onitemclick: onitemclick
onitemselect: onitemselect
onscroll: onscroll
dynamiclayout: dynamiclayout
dinamiclayout: dinamiclayout
setorientation: setorientation
linlayoutparam: linlayoutparam
ask: ask
base: base
inherits: inherits
bottommargin: bottommargin
leftmargin: leftmargin
rightmargin: rightmargin
topmargin: topmargin
marginlayoutparams: marginlayoutparams
mutual: mutual
awaits: awaits
throught: throught
lpview: lpview
setlayoutparams: setlayoutparams
btn: btn
previously: previously
simultaneously: simultaneously
aligning: aligning
edge: edge
leftmarginparams: leftmarginparams
rightgravityparams: rightgravityparams
aligned: aligned
revise: revise
configuring: configuring
faq: faq
sqlitetransaction: sqlitetransaction
myactions: myactions
mytable: mytable
val: val
mydb: mydb
exception: exception exceptions
ex: ex
getmessage: getmessage
sqliteexception: sqliteexception
locked: locked
mdatabase: mdatabase
isopen: isopen
getwritabledatabse: getwritabledatabse
mdatabse: mdatabse
getreadabledatabase: getreadabledatabase
exclusive: exclusive
begintransactionnonexclusive: begintransactionnonexclusive
immediate: immediate
loader: loader
loadermanager: loadermanager
asynctaskloader: asynctaskloader
cursorloader: cursorloader
short: short
observer: observer
textappearancemedium: textappearancemedium
rgtimeformat: rgtimeformat
rdshort: rdshort
rdlong: rdlong
btngettime: btngettime
gettimeclick: gettimeclick
btnobserver: btnobserver
observerclick: observerclick
oncreateloader: oncreateloader
non: non
timeloader: timeloader
locale: locale
concurrent: concurrent
timeunit: timeunit
asynctask: asynctask
h: h
g: g
gettimetask: gettimetask
args: args
hashcode: hashcode
onstartloading: onstartloading
onstoploading: onstoploading
onforceload: onforceload
executeonexecutor: executeonexecutor
onabandon: onabandon
onreset: onreset
getresultfromtask: getresultfromtask
deliverresult: deliverresult
doinbackground: doinbackground
params: params
sleep: sleep
interruptedexception: interruptedexception
getdefault: getdefault
onpostexecute: onpostexecute
loadercallbacks: loadercallbacks
lastcheckedid: lastcheckedid
bndl: bndl
gettimeformat: gettimeformat
getloadermanager: getloadermanager
initloader: initloader
onloadfinished: onloadfinished
onloaderreset: onloaderreset
getloader: getloader
restartloader: restartloader
forceload: forceload
bunlde: bunlde
timeloaderoncreateloader: timeloaderoncreateloader
onstoploadingonloaderreset: onstoploadingonloaderreset
contentobserver: contentobserver
forceloadcontentobserver: forceloadcontentobserver
postdelayed: postdelayed
runnable: runnable
dispatchchange: dispatchchange
takecontentchanged: takecontentchanged
getsupportloadermanager: getsupportloadermanager
timeasyncloader: timeasyncloader
loadinbackground: loadinbackground
cancelload: cancelload
oncanceled: oncanceled
basicviews: basicviews
desing: desing
blueprint: blueprint
tree: tree
layoutinflaterlistpackage: layoutinflaterlistpackage
scrollview: scrollview
tvposition: tvposition
tvsalary: tvsalary
parsecolor: parsecolor
setbackgroundcolor: setbackgroundcolor
fragmentdynamic: fragmentdynamic
btnadd: btnadd
btnremove: btnremove
btnreplace: btnreplace
chbstack: chbstack
frgmcont: frgmcont
ftrans: ftrans
addtobackstack: addtobackstack
canvastext: canvastext
canvas: canvas
paint: paint
drawview: drawview
fontpaint: fontpaint
redpaint: redpaint
fontsize: fontsize
setcolor: setcolor
settextsize: settextsize
setstyle: setstyle
stroke: stroke
measuretext: measuretext
gettextwidths: gettextwidths
ondraw: ondraw
drawargb: drawargb
translate: translate
drawtext: drawtext
drawline: drawline
drawcircle: drawcircle
maxwidth: maxwidth
realwidth: realwidth
cnt: cnt
measuredwidth: measuredwidth
breaktext: breaktext
setstrokewidth: setstrokewidth
settypeface: settypeface
typeface: typeface
monospace: monospace
serif: serif
bold: bold
italic: italic
asset: assets
createfromasset: createfromasset
settextscalex: settextscalex
settextskewx: settextskewx
setunderlinetext: setunderlinetext
setstrikethrutext: setstrikethrutext
po: pos
drawpostext: drawpostext
pathmeasure: pathmeasure
migrating: migrating
updating: updating
onupdate: onupdate
migration: migration
newer: newer
employee: employees employee
suddenly: suddenly
organise: organise
ui: ui
databasae: databasae
ivan: ivan
maria: maria
petr: petr
anton: anton
dasha: dasha
boris: boris
kostja: kostja
igor: igor
accountant: accountant
director: director
security: security
grouped: grouped
selects: selects
rowsid: rowsid
fine: fine
designing: designing
addition: addition
possibly: possibly
keep: keep
script: scripts script
loss: losses
plan: plan
keeping: keeping
oriented: oriented
updation: updation
transaction: transaction transactions
canceled: canceled
secondly: secondly
transfer: transfer
original: original
updated: updated
giving: giving
since: since
rowsname: rowsname
correctly: correctly
fictional: fictional
complain: complain
argue: argue
requested: requested
safely: safely
sufficiently: sufficiently
studied: studied
freely: freely
composed: composed
mailbox: mailbox
widely: widely
checkboxes: checkboxes
approximately: approximately
situated: situated
placing: placing
confused: confused
review: review
targetapplication: targetapplication
namepackage: namepackage
namecreate: namecreate
configured: configured
divided: divided
palette: palette
glance: glance
present: present
outline: outline
meaningful: meaningful
inscription: inscription inscriptions
custom: custom
form: form
contextmenupackage: contextmenupackage
contextmenucreate: contextmenucreate
tvcolor: tvcolor
tvsize: tvsize
contextmenu: contextmenu
contextmenuinfo: contextmenuinfo
registerforcontextmenu: registerforcontextmenu
oncreatecontextmenu: oncreatecontextmenu
menuinfo: menuinfo
oncontextitemselected: oncontextitemselected
setoncreatecontextmenulistener: setoncreatecontextmenulistener
oncreatecontextmenulistener: oncreatecontextmenulistener
layoutfiles: layoutfiles
myscreen: myscreen
alt: alt
plain: plain
landscape: landscape
land: land
applies: applies
subtraction: subtraction
multiplication: multiplication
division: division
expression: expression
simplecalculator: simplecalculator
inputtype: inputtype
numberdecimal: numberdecimal
btnsub: btnsub
btnmult: btnmult
btndiv: btndiv
tvresult: tvresult
letter: letter letters
checkings: checkings
confuse: confuse
oper: oper
parsefloat: parsefloat
extend: extend
clearing: clearing
reset: reset
quit: quit
fieldsquit: fieldsquit
homework: homework
zero: zero zeros
animation: animation
jdk: jdk
exe: exe
welcome: welcome
virtual: virtual
limited: limited
structured: structured
enquire: enquire
interacts: interacts
connecting: connecting
obsolete: obsolete
actual: actual
responsibility: responsibility
heavy: heavy
master: master
technique: techniques
simplesqlite: simplesqlite
email: email
etemail: etemail
btnread: btnread
control: control
insertion: insertion
rowid: rowid
inserted: inserted
idcolindex: idcolindex
namecolindex: namecolindex
emailcolindex: emailcolindex
getint: getint
clearcount: clearcount
management: management
parametres: parametres
inserting: inserting
pasted: pasted
grouping: grouping
sorting: sorting
considered: considered
removing: removing
nested: nested
said: said
cursos: cursos
gonna: gonna
happening: happening
executed: executed
body: body
loot: loot
connects: connects
onupgrate: onupgrate
exact: exact
slow: slow
architecture: architecture
livedata: livedata
viewmodel: viewmodel
room: room
paging: paging
simpler: simpler
enumeration: enumeration
afterwards: afterwards
broaden: broaden
horizon: horizons
thought: thoughts
turning: turning
reviewed: reviewed
pdf: pdf
upd: upd
hvga: hvga
wizard: wizard
constantly: constantly
suit: suits
newest: newest
propose: propose
older: older
nicely: nicely
conveniently: conveniently
ourfirstproject: ourfirstproject
directly: directly
shortly: shortly
minimum: minimum
tested: tested
compatibility: compatibility
none: none
immediately: immediately
manually: manually
workspace: workspace
blankactivity: blankactivity
touch: touch
splitted: splitted
frequently: frequently
src: src
gen: gen
filed: filed
configuration: configuration
advise: advise
laggy: laggy
unstable: unstable
startup: startup
minute: minutes minute
unlock: unlock
observe: observe
disconnected: disconnected
cancelling: cancelling
mainact: mainact
restart: restart
reboot: reboot
motion: motions
computer: computer
spotted: spotted
tendency: tendency
fault: faults
sit: sit
video: video
rendering: rendering
sap: sap
pi: pi
abap: abap
webdynpro: webdynpro
bsp: bsp
service: services service
bpm: bpm
linkedin: linkedin
testing: testing
importance: importance
descending: descending
dropdown: dropdown
higher: higher
lstener: lstener
asked: asked
successfully: successfully
wish: wish
newly: newly
representation: representation
indicating: indicating
syntax: syntax
absolutelayout: absolutelayout
layoutspackage: layoutspackage
layoutscreate: layoutscreate
groupview: groupview
tl: tl
tr: tr
tlayout: tlayout
rlayout: rlayout
alayout: alayout
surname: surname
mainacitivty: mainacitivty
acquainted: acquainted
variety: varieties
equipped: equipped
incoming: incoming
whatever: whatever
receiving: receiving
ourself: ourself
uncommon: uncommon
supporting: supporting
suggests: suggests
intentfilters: intentfilters
alternative: alternative
webpage: webpage
damn: damn
random: random
dark: dark
rubbish: rubbish
ethic: ethics
adequacy: adequacy
sense: sense
dpвокруг: dpвокруг
dpотступ: dpотступ
cs: css
icamys: icamys
rotate: rotate
bug: bug
extension: extensions
obligatory: obligatory
preview: preview
graphical: graphical
readable: readable
glitch: glitches
notify: notify
creator: creators
solved: solved
identically: identically
destination: destination
earlier: earlier
suffix: suffixes suffix
understands: understands
explored: explored
grant: grants
kindly: kindly
hint: hints
combination: combination
goal: goal
sending: sending
depend: depend
music: music
player: players
compared: compared
lock: lock
awesome: awesome
gradually: gradually
sends: sends
illustration: illustrations
deliver: deliver
idea: idea
parcel: parcel
parcelable: parcelable
handler: handler
viewpager: viewpager
gps: gps
recommends: recommends
adt: adt
positioning: positioning
depends: depends
username: username
password: password
secret: secret
storage: storage
represent: represent
unique: unique
upper: upper
ellipsis: ellipsis
branch: branch
highlight: highlight
accomplished: accomplished
conclusion: conclusion
split: split
recommendation: recommendation
evidence: evidence
prevailing: prevailing
bin: bin
domain: domain
androidstudioprojects: androidstudioprojects
androidlessons: androidlessons
tablet: tablet
firstproject: firstproject
monitor: monitor
relatively: relatively
complexity: complexity
drag: drag
trs: trs
overall: overall
widest: widest
textviews: textviews
exercise: exercise
relationship: relationships
centered: centered
omit: omit
analyze: analyze
adjacent: adjacent
rarely: rarely
intuitive: intuitive
wherever: wherever
shifted: shifted
planned: planned
guaranteed: guaranteed
optimizing: optimizing
listenerpackage: listenerpackage
listenercreate: listenercreate
prepare: prepare
oclbtn: oclbtn
operator: operator
rule: rule rules
allocated: allocated
especially: especially
mobile: mobile
optimization: optimization
reduced: reduced
assigened: assigened
activitylistenerpackage: activitylistenerpackage
activitylistenercreate: activitylistenercreate
anyway: anyway
expenditure: expenditure
minimal: minimal
preferred: preferred
incomprehensible: incomprehensible
describing: describing
btnstart: btnstart
onclickstart: onclickstart
inisde: inisde
requirement: requirements
retrolambda: retrolambda
merge: merge
concat: concat
amb: amb
zip: zip
combinelatest: combinelatest
withlatestfrom: withlatestfrom
flatmap: flatmap
concatmap: concatmap
androidinjectionв: androidinjectionв
builderв: builderв
onerrorreturn: onerrorreturn
onerrorresumenext: onerrorresumenext
onexceptionresumenext: onexceptionresumenext
observable: observable
retry: retry
retrywhen: retrywhen
subcribeon: subcribeon
observeon: observeon
subscribeon: subscribeon
publishsubject: publishsubject
replaysubject: replaysubject
behaviorsubject: behaviorsubject
asyncsubject: asyncsubject
unicastsubject: unicastsubject
serializedsubject: serializedsubject
compositesubscription: compositesubscription
hot: hot
connectableobservableв: connectableobservableв
cold: cold
publish: publish
replay: replay
refcount: refcount
connectableobservable: connectableobservable
observale: observale
subscription: subscription
installing: installing
installation: installation
instruction: instructions
software: software
seven: seven
recently: recently
reliable: reliable
six: six
edition: edition
accept: accept
licence: licence
agreement: agreement
ide: ide
wich: wich
platformes: platformes
forever: forever
reconfigure: reconfigure
highly: highly
disc: disc
perfect: perfect
f: f
archive: archive
fancy: fancy
classic: classic
proposal: proposal
suited: suited
configures: configures
walk: walk
dl: dl
ssl: ssl
trouble: troubles
warning: warning
authenticity: authenticity
validity: validity
established: established
pop: pops
lasted: lasted
restarting: restarting
additionally: additionally
latest: latest
extracted: extracted
statistic: statistics statistic
missing: missing
proposed: proposed
via: via
stated: stated
account: accounts account
mb: mb
administrator: administrator
arm: arm
eabi: eabi
traffic: traffic
sample: sample samples
applicationsgoogle: applicationsgoogle
weigh: weigh
gigabyte: gigabyte
reject: reject
indicator: indicator
phrase: phrase
weighted: weighted
gb: gb
performing: performing
maybe: maybe
dull: dull
boring: boring
fun: fun
googling: googling
facing: facing
forum: forum
setup: setup
accidentally: accidentally
popped: popped
informs: informs
product: product
greedy: greedy
reached: reached
included: included
probably: probably
high: high
twoactivity: twoactivity
pening: pening
listed: listed
job: job
lack: lack
reality: reality
mainacivity: mainacivity
twoactivitymodule: twoactivitymodule
appcompatactivity: appcompatactivity
allowbackup: allowbackup
mipmap: mipmap
roundicon: roundicon
supportsrtl: supportsrtl
apptheme: apptheme
profiler: profiler
performance: performance
strictmode: strictmode
garbage: garbage
collector: collector
low: low
ontrimmemory: ontrimmemory
allocation: allocation
dump: dump
weakreference: weakreference
anonymous: anonymous
leakcanary: leakcanary
cpu: cpu
chart: chart
flame: flame
network: network
profilerв: profilerв
energy: energy
analyzerв: analyzerв
analyzer: analyzer
systraceв: systraceв
systrace: systrace
subjectв: subjectв
observeonв: observeonв
retrolambdaв: retrolambdaв
backpressureв: backpressureв
backpressure: backpressure
onbackpressure: onbackpressure
synconsubscribe: synconsubscribe
flowable: flowable
rxbindingв: rxbindingв
rxbinding: rxbinding
rxjavapluginsв: rxjavapluginsв
testobserver: testobserver
testscheduler: testscheduler
rxjavaplugins: rxjavaplugins
suspend: suspend
continuation: continuation
async: async
dispatcher: dispatcher
coroutineexceptionhandler: coroutineexceptionhandler
coroutinescope: coroutinescope
supervisorscope: supervisorscope
withcontext: withcontext
runblocking: runblocking
consume: consume
broadcast: broadcast
flow: flow
channelflow: channelflow
flowon: flowon
producein: producein
viewmodelscope: viewmodelscope
lifecyclescope: lifecyclescope
mainscope: mainscope
roomв: roomв
usecase: usecase
sharedflow: sharedflow
stateflow: stateflow
runblockingtest: runblockingtest
testcoroutinedispatcher: testcoroutinedispatcher
assert: assert
assertthat: assertthat
mock: mock
mockito: mockito
espresso: espresso
viewmatcher: viewmatcher
viewaction: viewaction
viewassertion: viewassertion
adapterview: adapterview
idlingresource: idlingresource
activitytestrule: activitytestrule
intentstestrule: intentstestrule
junit: junit
parameterized: parameterized
timeout: timeout
habrahabr: habrahabr
constraintlayoutintromodule: constraintlayoutintromodule
del: del
constrained: constrained
designtime: designtime
jump: jump
unless: unless
servicesimple: servicesimple
btnstop: btnstop
onclickstop: onclickstop
progressbar: progressbar
indeterminate: indeterminate
myservice: myservice
ibinder: ibinder
onstartcommand: onstartcommand
flag: flags
startid: startid
sometask: sometask
onbind: onbind
startservice: startservice
stopservice: stopservice
oncreateonstartcommand: oncreateonstartcommand
oncreateonstartcommandi: oncreateonstartcommandi
stopself: stopself
stopselfresult: stopselfresult
